"Codice provincia","Provincia","Et√†","Maschi celibi","Maschi coniugati","Maschi divorziati","Maschi vedovi","Totale Maschi","Femmine nubili","Femmine coniugate","Femmine divorziate","Femmine vedove","Totale Femmine"
"001","Torino",0,10161,0,0,0,10161,9452,0,0,0,9452
"001","Torino",1,10100,0,0,0,10100,9629,0,0,0,9629
"001","Torino",2,10453,0,0,0,10453,9803,0,0,0,9803
"001","Torino",3,10583,0,0,0,10583,9935,0,0,0,9935
"001","Torino",4,10389,0,0,0,10389,9879,0,0,0,9879
"001","Torino",5,10451,0,0,0,10451,9603,0,0,0,9603
"001","Torino",6,10203,0,0,0,10203,9689,0,0,0,9689
"001","Torino",7,10199,0,0,0,10199,9612,0,0,0,9612
"001","Torino",8,10230,0,0,0,10230,9739,0,0,0,9739
"001","Torino",9,9791,0,0,0,9791,9557,0,0,0,9557
"001","Torino",10,9745,0,0,0,9745,9351,0,0,0,9351
"001","Torino",11,10178,0,0,0,10178,9640,0,0,0,9640
"001","Torino",12,10002,0,0,0,10002,9229,0,0,0,9229
"001","Torino",13,9876,0,0,0,9876,9316,0,0,0,9316
"001","Torino",14,9654,0,0,0,9654,9280,0,0,0,9280
"001","Torino",15,9569,0,0,0,9569,9075,0,0,0,9075
"001","Torino",16,9485,0,0,0,9485,8885,1,0,0,8886
"001","Torino",17,9708,0,0,0,9708,8892,2,0,0,8894
"001","Torino",18,9542,1,0,0,9543,9150,16,0,0,9166
"001","Torino",19,9950,3,0,0,9953,9187,77,0,1,9265
"001","Torino",20,10109,15,0,0,10124,9283,221,2,0,9506
"001","Torino",21,10157,39,2,0,10198,9270,364,6,0,9640
"001","Torino",22,10018,109,0,0,10127,9024,616,6,0,9646
"001","Torino",23,10167,207,1,2,10377,8893,946,13,0,9852
"001","Torino",24,9762,358,4,2,10126,8716,1384,20,4,10124
"001","Torino",25,10007,584,5,2,10598,8514,1747,26,4,10291
"001","Torino",26,9952,883,7,2,10844,8513,2451,40,6,11010
"001","Torino",27,9595,1297,11,2,10905,8131,3015,50,6,11202
"001","Torino",28,9613,1868,8,3,11492,7723,3786,71,5,11585
"001","Torino",29,9563,2607,20,3,12193,7428,4721,100,14,12263
"001","Torino",30,8851,3305,35,4,12195,6842,5471,129,29,12471
"001","Torino",31,8485,4044,36,2,12567,6438,6317,160,21,12936
"001","Torino",32,8536,4752,55,5,13348,6292,7142,224,23,13681
"001","Torino",33,8292,5654,85,9,14040,6237,7846,297,34,14414
"001","Torino",34,8305,6457,131,5,14898,6219,8821,369,39,15448
"001","Torino",35,8027,7415,165,6,15613,5769,9690,455,59,15973
"001","Torino",36,8079,8428,232,11,16750,5825,10524,602,63,17014
"001","Torino",37,7886,9451,318,12,17667,5636,11372,656,79,17743
"001","Torino",38,7517,9749,339,16,17621,5213,11539,729,89,17570
"001","Torino",39,7034,10602,432,29,18097,4774,12061,965,111,17911
"001","Torino",40,6647,10910,515,27,18099,4524,12821,1034,132,18511
"001","Torino",41,6172,11249,584,22,18027,4236,12795,1116,179,18326
"001","Torino",42,5838,11903,709,36,18486,3934,13381,1252,180,18747
"001","Torino",43,5330,12333,775,43,18481,3558,13409,1319,216,18502
"001","Torino",44,4910,12450,808,50,18218,3447,13531,1386,236,18600
"001","Torino",45,4648,12580,928,75,18231,3173,13784,1362,275,18594
"001","Torino",46,4310,12618,965,88,17981,2934,13791,1516,340,18581
"001","Torino",47,3994,13074,1074,63,18205,2762,14021,1477,356,18616
"001","Torino",48,3458,12401,969,92,16920,2483,13380,1511,442,17816
"001","Torino",49,2931,12080,1015,117,16143,2226,13060,1498,469,17253
"001","Torino",50,2861,12280,985,87,16213,1987,13010,1423,538,16958
"001","Torino",51,2487,11859,996,124,15466,1740,12522,1469,581,16312
"001","Torino",52,2380,11949,1021,126,15476,1663,12464,1376,595,16098
"001","Torino",53,2222,11574,963,158,14917,1563,12389,1368,674,15994
"001","Torino",54,2046,11703,989,161,14899,1466,12258,1299,816,15839
"001","Torino",55,1844,11881,947,208,14880,1421,12177,1317,858,15773
"001","Torino",56,1764,11603,875,206,14448,1310,11782,1249,943,15284
"001","Torino",57,1671,11460,889,259,14279,1196,11711,1172,1104,15183
"001","Torino",58,1498,11027,789,263,13577,1050,11450,1102,1170,14772
"001","Torino",59,1368,11319,749,270,13706,1111,11347,1019,1268,14745
"001","Torino",60,1331,10951,719,326,13327,947,11339,959,1395,14640
"001","Torino",61,1329,11451,730,346,13856,907,11721,977,1622,15227
"001","Torino",62,1200,11890,679,414,14183,931,11879,859,1862,15531
"001","Torino",63,1273,12646,681,474,15074,945,12431,916,2154,16446
"001","Torino",64,1121,12695,623,531,14970,887,12142,857,2235,16121
"001","Torino",65,1095,12469,603,563,14730,838,11754,837,2556,15985
"001","Torino",66,851,9685,446,474,11456,639,9025,559,2203,12426
"001","Torino",67,810,10231,418,582,12041,716,9474,599,2556,13345
"001","Torino",68,859,9993,391,617,11860,713,9364,601,2803,13481
"001","Torino",69,865,10048,347,735,11995,726,9181,570,3085,13562
"001","Torino",70,829,9957,337,722,11845,755,8952,508,3457,13672
"001","Torino",71,882,10948,365,949,13144,864,9584,505,4164,15117
"001","Torino",72,848,10841,287,997,12973,852,9287,480,4512,15131
"001","Torino",73,782,10492,317,1018,12609,822,8569,461,4808,14660
"001","Torino",74,737,9346,255,1050,11388,800,7479,404,4802,13485
"001","Torino",75,613,8524,217,1061,10415,782,6634,359,4967,12742
"001","Torino",76,607,8236,186,1114,10143,785,6232,316,5498,12831
"001","Torino",77,538,7509,152,1098,9297,724,5507,292,5647,12170
"001","Torino",78,482,6964,137,1118,8701,710,4846,267,5788,11611
"001","Torino",79,468,6314,140,1144,8066,750,4358,224,6078,11410
"001","Torino",80,452,5911,110,1148,7621,770,3879,198,6280,11127
"001","Torino",81,439,5592,103,1247,7381,785,3508,216,6485,10994
"001","Torino",82,378,4596,80,1120,6174,754,2668,174,6101,9697
"001","Torino",83,298,3851,58,1132,5339,713,2153,166,5907,8939
"001","Torino",84,253,3257,52,1028,4590,703,1781,141,5884,8509
"001","Torino",85,193,2680,37,985,3895,603,1313,103,5453,7472
"001","Torino",86,213,2104,28,915,3260,610,1069,98,5115,6892
"001","Torino",87,159,1706,15,888,2768,572,779,91,4544,5986
"001","Torino",88,129,1407,14,818,2368,465,589,69,4310,5433
"001","Torino",89,113,1087,21,756,1977,439,383,68,3933,4823
"001","Torino",90,66,878,12,617,1573,380,267,62,3397,4106
"001","Torino",91,62,603,11,515,1191,266,197,40,2746,3249
"001","Torino",92,33,282,4,235,554,187,80,16,1516,1799
"001","Torino",93,32,167,3,181,383,112,42,10,1032,1196
"001","Torino",94,17,106,1,113,237,101,23,15,847,986
"001","Torino",95,12,80,2,137,231,88,28,7,822,945
"001","Torino",96,11,81,0,121,213,80,16,9,768,873
"001","Torino",97,12,50,2,74,138,70,10,4,639,723
"001","Torino",98,3,37,1,65,106,55,17,4,426,502
"001","Torino",99,3,17,0,36,56,44,6,0,298,348
"001","Torino",100,6,17,0,52,75,52,6,2,438,498
"002","Vercelli",0,683,0,0,0,683,621,0,0,0,621
"002","Vercelli",1,732,0,0,0,732,625,0,0,0,625
"002","Vercelli",2,733,0,0,0,733,682,0,0,0,682
"002","Vercelli",3,693,0,0,0,693,697,0,0,0,697
"002","Vercelli",4,768,0,0,0,768,725,0,0,0,725
"002","Vercelli",5,738,0,0,0,738,670,0,0,0,670
"002","Vercelli",6,686,0,0,0,686,686,0,0,0,686
"002","Vercelli",7,704,0,0,0,704,650,0,0,0,650
"002","Vercelli",8,765,0,0,0,765,680,0,0,0,680
"002","Vercelli",9,727,0,0,0,727,695,0,0,0,695
"002","Vercelli",10,720,0,0,0,720,660,0,0,0,660
"002","Vercelli",11,742,0,0,0,742,686,0,0,0,686
"002","Vercelli",12,724,0,0,0,724,697,0,0,0,697
"002","Vercelli",13,728,0,0,0,728,712,0,0,0,712
"002","Vercelli",14,715,0,0,0,715,696,0,0,0,696
"002","Vercelli",15,709,0,0,0,709,706,0,0,0,706
"002","Vercelli",16,758,0,0,0,758,660,0,0,0,660
"002","Vercelli",17,772,0,0,0,772,700,0,0,0,700
"002","Vercelli",18,737,0,0,0,737,684,1,0,0,685
"002","Vercelli",19,771,1,1,0,773,679,7,0,0,686
"002","Vercelli",20,804,2,3,0,809,703,18,0,0,721
"002","Vercelli",21,814,2,2,0,818,735,37,0,0,772
"002","Vercelli",22,752,5,2,0,759,709,70,0,0,779
"002","Vercelli",23,823,13,0,0,836,691,84,1,0,776
"002","Vercelli",24,791,33,3,0,827,670,112,4,0,786
"002","Vercelli",25,748,47,1,0,796,650,156,1,1,808
"002","Vercelli",26,765,72,1,0,838,644,205,4,0,853
"002","Vercelli",27,813,94,0,0,907,618,227,3,0,848
"002","Vercelli",28,725,131,1,0,857,589,306,5,2,902
"002","Vercelli",29,809,192,2,0,1003,541,355,5,0,901
"002","Vercelli",30,763,248,3,0,1014,558,362,10,0,930
"002","Vercelli",31,675,267,3,2,947,461,475,9,3,948
"002","Vercelli",32,651,361,8,1,1021,425,493,12,1,931
"002","Vercelli",33,719,369,17,0,1105,466,568,21,3,1058
"002","Vercelli",34,648,422,10,1,1081,420,667,27,7,1121
"002","Vercelli",35,618,527,14,0,1159,432,696,29,5,1162
"002","Vercelli",36,631,599,12,2,1244,379,743,46,8,1176
"002","Vercelli",37,609,613,22,3,1247,352,779,52,5,1188
"002","Vercelli",38,539,703,37,0,1279,353,874,57,10,1294
"002","Vercelli",39,576,747,29,1,1353,360,883,60,13,1316
"002","Vercelli",40,530,798,32,2,1362,358,907,73,8,1346
"002","Vercelli",41,493,797,57,0,1347,266,927,87,12,1292
"002","Vercelli",42,456,912,64,2,1434,283,1010,95,9,1397
"002","Vercelli",43,442,887,55,3,1387,270,980,101,15,1366
"002","Vercelli",44,368,929,78,2,1377,232,1023,87,23,1365
"002","Vercelli",45,410,982,66,5,1463,216,1106,93,22,1437
"002","Vercelli",46,385,1048,78,2,1513,234,1113,102,29,1478
"002","Vercelli",47,350,1039,88,10,1487,235,1083,109,37,1464
"002","Vercelli",48,304,1029,88,6,1427,198,1066,101,35,1400
"002","Vercelli",49,298,1004,76,13,1391,191,1004,117,47,1359
"002","Vercelli",50,251,1006,64,8,1329,187,1062,100,63,1412
"002","Vercelli",51,238,981,83,10,1312,146,1051,103,59,1359
"002","Vercelli",52,238,943,77,18,1276,148,987,87,48,1270
"002","Vercelli",53,202,942,73,11,1228,133,997,98,69,1297
"002","Vercelli",54,178,908,74,15,1175,121,978,104,68,1271
"002","Vercelli",55,190,933,70,19,1212,108,970,90,96,1264
"002","Vercelli",56,187,979,68,25,1259,104,948,74,88,1214
"002","Vercelli",57,148,894,58,17,1117,113,916,92,89,1210
"002","Vercelli",58,142,915,74,20,1151,111,896,62,102,1171
"002","Vercelli",59,152,960,66,18,1196,77,879,60,138,1154
"002","Vercelli",60,113,948,60,27,1148,63,930,63,123,1179
"002","Vercelli",61,141,963,54,40,1198,94,888,65,150,1197
"002","Vercelli",62,136,944,42,45,1167,72,944,62,170,1248
"002","Vercelli",63,134,1016,65,42,1257,69,942,75,197,1283
"002","Vercelli",64,115,959,50,45,1169,78,913,63,198,1252
"002","Vercelli",65,112,918,45,53,1128,63,863,56,226,1208
"002","Vercelli",66,90,667,29,36,822,53,655,25,195,928
"002","Vercelli",67,94,758,26,58,936,55,667,44,220,986
"002","Vercelli",68,73,664,30,57,824,70,687,30,249,1036
"002","Vercelli",69,94,716,30,48,888,51,665,40,265,1021
"002","Vercelli",70,98,735,24,54,911,79,697,26,267,1069
"002","Vercelli",71,86,897,30,47,1060,74,734,33,379,1220
"002","Vercelli",72,87,813,18,83,1001,74,737,40,438,1289
"002","Vercelli",73,90,759,20,88,957,74,692,32,424,1222
"002","Vercelli",74,82,713,19,73,887,83,594,28,438,1143
"002","Vercelli",75,80,655,14,103,852,66,541,19,424,1050
"002","Vercelli",76,83,667,18,83,851,73,525,22,578,1198
"002","Vercelli",77,68,607,14,100,789,67,455,15,532,1069
"002","Vercelli",78,61,561,6,119,747,68,385,15,552,1020
"002","Vercelli",79,61,531,19,105,716,72,356,14,652,1094
"002","Vercelli",80,52,537,3,95,687,74,343,9,608,1034
"002","Vercelli",81,54,468,12,111,645,86,252,11,688,1037
"002","Vercelli",82,52,389,6,104,551,73,243,21,640,977
"002","Vercelli",83,43,350,8,101,502,66,170,9,648,893
"002","Vercelli",84,32,277,2,102,413,96,164,9,591,860
"002","Vercelli",85,39,255,3,97,394,73,127,15,566,781
"002","Vercelli",86,24,203,0,111,338,53,103,6,496,658
"002","Vercelli",87,22,170,2,72,266,61,78,5,479,623
"002","Vercelli",88,16,160,2,89,267,59,57,4,429,549
"002","Vercelli",89,9,108,3,79,199,49,40,2,419,510
"002","Vercelli",90,8,81,0,66,155,27,19,7,312,365
"002","Vercelli",91,6,64,2,45,117,36,9,5,312,362
"002","Vercelli",92,5,29,1,28,63,19,10,0,136,165
"002","Vercelli",93,3,7,1,8,19,10,3,1,103,117
"002","Vercelli",94,1,5,1,9,16,5,1,0,91,97
"002","Vercelli",95,1,8,0,14,23,11,0,0,84,95
"002","Vercelli",96,4,8,0,13,25,7,1,0,101,109
"002","Vercelli",97,0,9,0,9,18,8,0,0,76,84
"002","Vercelli",98,2,1,0,9,12,3,0,0,54,57
"002","Vercelli",99,0,2,0,3,5,3,0,0,36,39
"002","Vercelli",100,2,2,0,3,7,6,1,0,50,57
"003","Novara",0,1697,0,0,0,1697,1587,0,0,0,1587
"003","Novara",1,1696,0,0,0,1696,1607,0,0,0,1607
"003","Novara",2,1693,0,0,0,1693,1677,0,0,0,1677
"003","Novara",3,1698,0,0,0,1698,1655,0,0,0,1655
"003","Novara",4,1757,0,0,0,1757,1750,0,0,0,1750
"003","Novara",5,1679,0,0,0,1679,1724,0,0,0,1724
"003","Novara",6,1665,0,0,0,1665,1646,0,0,0,1646
"003","Novara",7,1663,0,0,0,1663,1560,0,0,0,1560
"003","Novara",8,1668,0,0,0,1668,1568,0,0,0,1568
"003","Novara",9,1674,0,0,0,1674,1583,0,0,0,1583
"003","Novara",10,1689,0,0,0,1689,1477,0,0,0,1477
"003","Novara",11,1675,0,0,0,1675,1601,0,0,0,1601
"003","Novara",12,1643,0,0,0,1643,1538,0,0,0,1538
"003","Novara",13,1641,0,0,0,1641,1530,0,0,0,1530
"003","Novara",14,1641,0,0,0,1641,1540,0,0,0,1540
"003","Novara",15,1588,0,0,0,1588,1429,0,0,0,1429
"003","Novara",16,1604,0,0,0,1604,1505,0,0,0,1505
"003","Novara",17,1538,0,0,0,1538,1557,0,0,0,1557
"003","Novara",18,1625,0,0,0,1625,1458,7,0,0,1465
"003","Novara",19,1637,0,0,0,1637,1629,19,0,0,1648
"003","Novara",20,1600,3,5,0,1608,1542,58,1,0,1601
"003","Novara",21,1635,12,0,0,1647,1429,92,2,0,1523
"003","Novara",22,1648,24,0,0,1672,1515,167,0,0,1682
"003","Novara",23,1679,45,0,0,1724,1460,229,1,0,1690
"003","Novara",24,1661,73,1,0,1735,1457,271,0,0,1728
"003","Novara",25,1674,112,3,0,1789,1385,366,1,0,1752
"003","Novara",26,1578,145,0,0,1723,1277,473,3,0,1753
"003","Novara",27,1618,255,0,0,1873,1257,567,1,0,1825
"003","Novara",28,1639,338,2,1,1980,1287,747,3,1,2038
"003","Novara",29,1668,461,0,0,2129,1196,881,11,1,2089
"003","Novara",30,1685,563,2,1,2251,1141,1027,23,3,2194
"003","Novara",31,1470,766,6,1,2243,1022,1101,22,5,2150
"003","Novara",32,1416,882,13,1,2312,965,1267,22,5,2259
"003","Novara",33,1464,1064,16,1,2545,940,1407,23,15,2385
"003","Novara",34,1409,1192,15,0,2616,971,1548,45,7,2571
"003","Novara",35,1329,1300,22,2,2653,904,1694,73,10,2681
"003","Novara",36,1410,1463,36,1,2910,872,1804,87,12,2775
"003","Novara",37,1304,1622,53,1,2980,821,1983,102,8,2914
"003","Novara",38,1210,1725,54,2,2991,735,2008,103,13,2859
"003","Novara",39,1078,1837,67,4,2986,720,2054,119,15,2908
"003","Novara",40,1115,1866,84,6,3071,672,2066,142,21,2901
"003","Novara",41,963,1841,89,6,2899,594,2151,154,32,2931
"003","Novara",42,951,2123,113,8,3195,571,2213,189,34,3007
"003","Novara",43,870,2033,117,4,3024,546,2245,185,27,3003
"003","Novara",44,826,2109,129,17,3081,496,2232,165,60,2953
"003","Novara",45,790,2250,141,7,3188,517,2350,202,47,3116
"003","Novara",46,641,2209,150,10,3010,457,2442,204,63,3166
"003","Novara",47,601,2341,169,21,3132,416,2506,208,49,3179
"003","Novara",48,548,2254,145,17,2964,376,2294,165,81,2916
"003","Novara",49,511,2192,148,21,2872,370,2193,172,78,2813
"003","Novara",50,464,2185,171,8,2828,338,2221,189,73,2821
"003","Novara",51,417,2065,148,19,2649,300,2249,191,108,2848
"003","Novara",52,382,2138,143,20,2683,298,2073,167,118,2656
"003","Novara",53,347,2005,125,33,2510,257,1968,169,122,2516
"003","Novara",54,323,1934,123,43,2423,260,2052,167,109,2588
"003","Novara",55,316,1930,116,27,2389,213,1947,153,109,2422
"003","Novara",56,266,1943,114,41,2364,192,1977,152,170,2491
"003","Novara",57,279,1900,109,40,2328,206,1944,126,171,2447
"003","Novara",58,251,1890,108,56,2305,164,1801,121,190,2276
"003","Novara",59,235,1926,112,39,2312,177,1831,113,195,2316
"003","Novara",60,196,1857,99,42,2194,158,1784,116,219,2277
"003","Novara",61,201,1940,86,56,2283,168,1831,120,285,2404
"003","Novara",62,189,1908,81,62,2240,136,1860,115,296,2407
"003","Novara",63,200,1945,87,71,2303,139,1879,105,356,2479
"003","Novara",64,190,1872,90,80,2232,151,1798,105,403,2457
"003","Novara",65,158,1877,94,88,2217,125,1658,98,406,2287
"003","Novara",66,112,1380,49,72,1613,99,1322,74,360,1855
"003","Novara",67,130,1461,57,82,1730,103,1328,75,399,1905
"003","Novara",68,121,1381,44,79,1625,106,1268,66,482,1922
"003","Novara",69,127,1407,55,102,1691,126,1276,56,507,1965
"003","Novara",70,120,1378,41,107,1646,143,1349,58,571,2121
"003","Novara",71,141,1505,50,144,1840,115,1431,52,674,2272
"003","Novara",72,139,1514,49,147,1849,164,1318,63,733,2278
"003","Novara",73,134,1490,32,156,1812,133,1263,50,801,2247
"003","Novara",74,103,1366,31,152,1652,135,1100,37,819,2091
"003","Novara",75,91,1258,36,163,1548,133,948,29,798,1908
"003","Novara",76,106,1260,24,171,1561,131,840,34,963,1968
"003","Novara",77,82,1041,24,164,1311,86,782,30,955,1853
"003","Novara",78,90,978,14,165,1247,145,679,24,986,1834
"003","Novara",79,76,946,14,186,1222,127,615,28,1083,1853
"003","Novara",80,88,834,10,180,1112,145,531,20,1099,1795
"003","Novara",81,74,842,15,202,1133,169,475,37,1106,1787
"003","Novara",82,68,660,9,169,906,131,373,13,1098,1615
"003","Novara",83,51,587,4,177,819,144,340,13,1071,1568
"003","Novara",84,38,527,5,182,752,136,253,15,1033,1437
"003","Novara",85,36,412,4,141,593,119,195,10,973,1297
"003","Novara",86,40,337,3,141,521,112,144,11,919,1186
"003","Novara",87,30,283,2,128,443,96,116,4,820,1036
"003","Novara",88,15,230,3,111,359,94,95,8,770,967
"003","Novara",89,25,175,1,105,306,62,48,5,706,821
"003","Novara",90,11,119,1,98,229,49,39,9,631,728
"003","Novara",91,7,91,0,84,182,61,17,3,503,584
"003","Novara",92,3,37,1,42,83,22,10,1,264,297
"003","Novara",93,2,24,0,29,55,14,3,0,170,187
"003","Novara",94,3,16,0,19,38,16,4,1,133,154
"003","Novara",95,1,12,0,22,35,19,1,0,142,162
"003","Novara",96,0,24,0,24,48,20,5,1,142,168
"003","Novara",97,3,12,0,12,27,12,4,0,140,156
"003","Novara",98,1,5,0,13,19,17,1,1,91,110
"003","Novara",99,1,3,0,10,14,9,0,0,67,76
"003","Novara",100,0,6,0,12,18,10,1,0,98,109
"004","Cuneo",0,2823,0,0,0,2823,2466,0,0,0,2466
"004","Cuneo",1,2800,0,0,0,2800,2642,0,0,0,2642
"004","Cuneo",2,2806,0,0,0,2806,2783,0,0,0,2783
"004","Cuneo",3,2876,0,0,0,2876,2687,0,0,0,2687
"004","Cuneo",4,2791,0,0,0,2791,2693,0,0,0,2693
"004","Cuneo",5,2763,0,0,0,2763,2644,0,0,0,2644
"004","Cuneo",6,2809,0,0,0,2809,2565,0,0,0,2565
"004","Cuneo",7,2770,0,0,0,2770,2584,0,0,0,2584
"004","Cuneo",8,2679,0,0,0,2679,2609,0,0,0,2609
"004","Cuneo",9,2657,0,0,0,2657,2564,0,0,0,2564
"004","Cuneo",10,2775,0,0,0,2775,2654,0,0,0,2654
"004","Cuneo",11,2870,0,0,0,2870,2742,0,0,0,2742
"004","Cuneo",12,2749,0,0,0,2749,2654,0,0,0,2654
"004","Cuneo",13,2858,0,0,0,2858,2623,0,0,0,2623
"004","Cuneo",14,2800,0,0,0,2800,2678,0,0,0,2678
"004","Cuneo",15,2849,0,0,0,2849,2556,0,0,0,2556
"004","Cuneo",16,2766,0,0,0,2766,2625,1,0,0,2626
"004","Cuneo",17,2631,0,0,0,2631,2685,0,0,0,2685
"004","Cuneo",18,2720,0,0,0,2720,2606,15,0,0,2621
"004","Cuneo",19,2862,2,1,0,2865,2670,58,0,0,2728
"004","Cuneo",20,2853,9,4,0,2866,2531,123,0,0,2654
"004","Cuneo",21,2860,21,4,0,2885,2553,206,1,1,2761
"004","Cuneo",22,2883,35,6,0,2924,2498,323,3,0,2824
"004","Cuneo",23,2907,72,5,1,2985,2523,424,4,0,2951
"004","Cuneo",24,2742,147,7,0,2896,2310,562,11,1,2884
"004","Cuneo",25,2790,242,12,1,3045,2197,779,9,1,2986
"004","Cuneo",26,2760,365,10,0,3135,2056,915,12,2,2985
"004","Cuneo",27,2583,524,9,0,3116,1883,1172,16,2,3073
"004","Cuneo",28,2509,724,9,1,3243,1853,1272,17,4,3146
"004","Cuneo",29,2476,917,22,0,3415,1663,1572,31,7,3273
"004","Cuneo",30,2305,1094,7,1,3407,1517,1721,40,6,3284
"004","Cuneo",31,2222,1298,25,0,3545,1445,1992,49,9,3495
"004","Cuneo",32,2021,1489,25,3,3538,1327,2048,59,9,3443
"004","Cuneo",33,2035,1720,30,1,3786,1261,2216,86,14,3577
"004","Cuneo",34,1950,1845,43,3,3841,1223,2398,98,12,3731
"004","Cuneo",35,1859,2178,62,5,4104,1137,2655,129,9,3930
"004","Cuneo",36,1835,2361,65,6,4267,1210,2776,150,16,4152
"004","Cuneo",37,1802,2524,91,3,4420,1098,3083,181,28,4390
"004","Cuneo",38,1811,2653,117,2,4583,1040,3091,186,35,4352
"004","Cuneo",39,1583,2817,139,8,4547,1043,3147,203,30,4423
"004","Cuneo",40,1528,2899,177,3,4607,911,3349,225,40,4525
"004","Cuneo",41,1342,2979,137,8,4466,879,3230,240,35,4384
"004","Cuneo",42,1309,3203,199,13,4724,844,3428,284,48,4604
"004","Cuneo",43,1246,3305,207,17,4775,795,3525,302,42,4664
"004","Cuneo",44,1209,3316,200,10,4735,776,3478,317,73,4644
"004","Cuneo",45,1158,3315,219,13,4705,746,3589,289,62,4686
"004","Cuneo",46,1051,3506,236,19,4812,678,3595,290,109,4672
"004","Cuneo",47,946,3607,269,27,4849,627,3799,322,100,4848
"004","Cuneo",48,900,3334,218,34,4486,570,3387,330,104,4391
"004","Cuneo",49,800,3302,224,25,4351,519,3444,286,139,4388
"004","Cuneo",50,769,3246,224,21,4260,490,3314,298,126,4228
"004","Cuneo",51,667,3226,255,37,4185,492,3217,293,165,4167
"004","Cuneo",52,721,3157,232,39,4149,414,3194,275,195,4078
"004","Cuneo",53,615,3154,213,36,4018,384,2928,261,182,3755
"004","Cuneo",54,655,3086,218,49,4008,326,3109,280,198,3913
"004","Cuneo",55,547,2955,218,45,3765,337,3035,230,241,3843
"004","Cuneo",56,532,3025,205,57,3819,342,2934,222,270,3768
"004","Cuneo",57,507,2885,193,78,3663,264,2955,206,299,3724
"004","Cuneo",58,503,2884,165,69,3621,282,2858,206,276,3622
"004","Cuneo",59,507,2990,188,64,3749,276,2806,214,334,3630
"004","Cuneo",60,497,2829,178,79,3583,245,2837,170,361,3613
"004","Cuneo",61,489,3048,138,91,3766,229,2910,175,416,3730
"004","Cuneo",62,467,3034,147,105,3753,223,2884,172,452,3731
"004","Cuneo",63,452,3076,157,131,3816,234,3009,149,550,3942
"004","Cuneo",64,431,3005,163,135,3734,229,2777,131,568,3705
"004","Cuneo",65,403,2814,141,117,3475,207,2706,110,570,3593
"004","Cuneo",66,337,2238,92,96,2763,182,2079,104,533,2898
"004","Cuneo",67,374,2417,97,137,3025,179,2243,108,601,3131
"004","Cuneo",68,388,2412,75,142,3017,194,2122,98,701,3115
"004","Cuneo",69,412,2416,77,158,3063,206,2178,97,756,3237
"004","Cuneo",70,414,2409,83,182,3088,221,2169,80,871,3341
"004","Cuneo",71,473,2479,76,202,3230,218,2196,64,1005,3483
"004","Cuneo",72,423,2509,68,227,3227,248,1989,68,1130,3435
"004","Cuneo",73,430,2417,54,245,3146,241,2022,82,1149,3494
"004","Cuneo",74,425,2191,56,251,2923,228,1772,53,1205,3258
"004","Cuneo",75,322,1972,33,240,2567,221,1505,55,1241,3022
"004","Cuneo",76,344,1943,33,227,2547,266,1440,37,1380,3123
"004","Cuneo",77,323,1795,27,300,2445,239,1287,31,1446,3003
"004","Cuneo",78,310,1565,35,272,2182,234,1044,40,1514,2832
"004","Cuneo",79,296,1604,36,276,2212,222,997,28,1603,2850
"004","Cuneo",80,274,1414,17,302,2007,280,896,27,1624,2827
"004","Cuneo",81,261,1434,27,347,2069,260,796,19,1795,2870
"004","Cuneo",82,249,1161,13,290,1713,266,624,24,1683,2597
"004","Cuneo",83,233,953,16,312,1514,256,506,17,1709,2488
"004","Cuneo",84,194,829,13,293,1329,256,408,16,1594,2274
"004","Cuneo",85,146,683,8,244,1081,224,319,17,1549,2109
"004","Cuneo",86,124,603,5,256,988,206,257,15,1517,1995
"004","Cuneo",87,99,478,4,275,856,197,164,9,1303,1673
"004","Cuneo",88,75,388,4,222,689,150,144,5,1234,1533
"004","Cuneo",89,72,299,3,191,565,162,100,9,1115,1386
"004","Cuneo",90,45,204,1,151,401,140,54,10,923,1127
"004","Cuneo",91,48,160,2,118,328,104,44,5,766,919
"004","Cuneo",92,21,71,1,76,169,72,27,2,453,554
"004","Cuneo",93,9,53,0,45,107,40,13,1,304,358
"004","Cuneo",94,4,35,0,42,81,46,10,0,270,326
"004","Cuneo",95,10,30,1,53,94,49,10,0,229,288
"004","Cuneo",96,8,24,0,40,72,25,3,0,232,260
"004","Cuneo",97,3,22,0,20,45,36,3,0,193,232
"004","Cuneo",98,2,10,0,17,29,21,2,0,129,152
"004","Cuneo",99,4,6,0,12,22,21,0,0,86,107
"004","Cuneo",100,0,10,0,15,25,14,2,0,136,152
"005","Asti",0,923,0,0,0,923,863,0,0,0,863
"005","Asti",1,933,0,0,0,933,860,0,0,0,860
"005","Asti",2,966,0,0,0,966,934,0,0,0,934
"005","Asti",3,1009,0,0,0,1009,889,0,0,0,889
"005","Asti",4,1027,0,0,0,1027,867,0,0,0,867
"005","Asti",5,945,0,0,0,945,929,0,0,0,929
"005","Asti",6,982,0,0,0,982,912,0,0,0,912
"005","Asti",7,955,0,0,0,955,919,0,0,0,919
"005","Asti",8,965,0,0,0,965,903,0,0,0,903
"005","Asti",9,945,0,0,0,945,961,0,0,0,961
"005","Asti",10,928,0,0,0,928,927,0,0,0,927
"005","Asti",11,1004,0,0,0,1004,878,0,0,0,878
"005","Asti",12,972,0,0,0,972,898,0,0,0,898
"005","Asti",13,989,0,0,0,989,913,0,0,0,913
"005","Asti",14,889,0,0,0,889,895,0,0,0,895
"005","Asti",15,940,0,0,0,940,850,0,0,0,850
"005","Asti",16,949,0,0,0,949,876,1,0,0,877
"005","Asti",17,940,0,0,0,940,856,1,0,0,857
"005","Asti",18,983,0,0,0,983,808,7,0,0,815
"005","Asti",19,917,0,0,1,918,855,25,0,0,880
"005","Asti",20,900,7,0,0,907,827,38,0,0,865
"005","Asti",21,976,5,0,0,981,920,82,1,0,1003
"005","Asti",22,961,14,0,0,975,783,115,0,1,899
"005","Asti",23,1023,25,0,0,1048,837,146,0,0,983
"005","Asti",24,886,57,0,0,943,765,227,2,0,994
"005","Asti",25,944,77,0,0,1021,746,238,0,0,984
"005","Asti",26,909,107,0,0,1016,775,304,3,0,1082
"005","Asti",27,902,178,0,0,1080,693,342,5,2,1042
"005","Asti",28,827,213,0,0,1040,665,433,8,0,1106
"005","Asti",29,811,268,1,0,1080,616,527,4,3,1150
"005","Asti",30,789,320,3,0,1112,603,573,21,1,1198
"005","Asti",31,773,417,7,0,1197,499,629,15,4,1147
"005","Asti",32,731,510,9,2,1252,525,690,18,3,1236
"005","Asti",33,756,571,4,1,1332,478,799,31,4,1312
"005","Asti",34,694,652,11,2,1359,490,888,33,4,1415
"005","Asti",35,741,741,15,3,1500,455,936,45,9,1445
"005","Asti",36,697,822,34,1,1554,457,1038,40,6,1541
"005","Asti",37,708,895,27,2,1632,459,1090,58,11,1618
"005","Asti",38,663,920,38,2,1623,376,1051,64,11,1502
"005","Asti",39,610,1029,38,3,1680,405,1138,103,16,1662
"005","Asti",40,573,992,43,7,1615,364,1223,87,10,1684
"005","Asti",41,543,1121,42,2,1708,327,1186,96,20,1629
"005","Asti",42,563,1185,74,1,1823,350,1294,103,13,1760
"005","Asti",43,454,1151,64,7,1676,305,1272,109,20,1706
"005","Asti",44,482,1196,70,6,1754,294,1287,122,23,1726
"005","Asti",45,448,1214,88,9,1759,288,1335,138,28,1789
"005","Asti",46,403,1258,112,3,1776,275,1289,125,26,1715
"005","Asti",47,413,1239,80,6,1738,290,1348,125,34,1797
"005","Asti",48,343,1204,93,8,1648,212,1341,130,39,1722
"005","Asti",49,305,1213,75,8,1601,209,1229,119,37,1594
"005","Asti",50,288,1230,82,14,1614,188,1282,122,49,1641
"005","Asti",51,270,1190,104,16,1580,169,1243,116,63,1591
"005","Asti",52,258,1160,110,17,1545,143,1183,118,53,1497
"005","Asti",53,241,1185,75,13,1514,126,1132,120,73,1451
"005","Asti",54,204,1127,112,17,1460,144,1243,117,74,1578
"005","Asti",55,221,1177,86,20,1504,135,1188,82,101,1506
"005","Asti",56,205,1101,73,17,1396,132,1159,93,91,1475
"005","Asti",57,179,1138,80,31,1428,99,1137,101,110,1447
"005","Asti",58,167,1083,89,25,1364,96,1099,73,122,1390
"005","Asti",59,180,1119,61,41,1401,82,1111,81,122,1396
"005","Asti",60,153,1103,53,26,1335,95,1097,76,132,1400
"005","Asti",61,151,1226,76,38,1491,95,1146,84,159,1484
"005","Asti",62,142,1188,69,32,1431,80,1210,73,194,1557
"005","Asti",63,147,1285,62,42,1536,95,1280,63,216,1654
"005","Asti",64,133,1292,75,52,1552,81,1137,69,229,1516
"005","Asti",65,129,1176,45,53,1403,79,1133,63,253,1528
"005","Asti",66,110,892,38,37,1077,58,755,43,215,1071
"005","Asti",67,120,925,31,46,1122,54,826,38,268,1186
"005","Asti",68,103,950,26,57,1136,70,905,32,262,1269
"005","Asti",69,84,941,38,60,1123,44,852,28,283,1207
"005","Asti",70,125,873,24,69,1091,68,784,37,312,1201
"005","Asti",71,115,992,26,75,1208,62,871,29,398,1360
"005","Asti",72,120,918,27,70,1135,79,881,38,464,1462
"005","Asti",73,114,936,23,97,1170,57,805,25,518,1405
"005","Asti",74,98,868,19,105,1090,67,747,27,474,1315
"005","Asti",75,88,819,25,93,1025,68,587,18,509,1182
"005","Asti",76,84,804,16,111,1015,75,588,28,602,1293
"005","Asti",77,82,755,17,119,973,63,508,17,595,1183
"005","Asti",78,87,683,13,133,916,63,470,12,568,1113
"005","Asti",79,92,621,18,112,843,78,457,17,609,1161
"005","Asti",80,77,620,19,122,838,78,417,9,693,1197
"005","Asti",81,86,550,12,142,790,92,395,10,814,1311
"005","Asti",82,71,556,11,139,777,73,284,11,750,1118
"005","Asti",83,64,453,8,125,650,88,230,13,733,1064
"005","Asti",84,59,393,4,126,582,69,189,14,693,965
"005","Asti",85,43,294,7,136,480,72,167,11,703,953
"005","Asti",86,36,291,5,102,434,60,117,12,595,784
"005","Asti",87,35,201,1,100,337,69,88,10,574,741
"005","Asti",88,32,194,1,112,339,63,70,8,543,684
"005","Asti",89,22,139,3,106,270,59,53,6,554,672
"005","Asti",90,20,110,1,76,207,40,35,5,465,545
"005","Asti",91,16,89,0,67,172,35,31,1,394,461
"005","Asti",92,4,35,0,40,79,17,11,1,208,237
"005","Asti",93,4,20,0,31,55,14,2,0,109,125
"005","Asti",94,3,15,1,19,38,9,1,0,95,105
"005","Asti",95,2,16,0,13,31,11,5,0,119,135
"005","Asti",96,3,17,0,14,34,10,0,0,125,135
"005","Asti",97,2,6,0,16,24,11,2,1,70,84
"005","Asti",98,2,5,0,13,20,7,1,0,62,70
"005","Asti",99,1,2,2,11,16,3,0,0,52,55
"005","Asti",100,0,2,0,8,10,8,0,0,53,61
"006","Alessandria",0,1650,0,0,0,1650,1535,0,0,0,1535
"006","Alessandria",1,1645,0,0,0,1645,1521,0,0,0,1521
"006","Alessandria",2,1696,0,0,0,1696,1565,0,0,0,1565
"006","Alessandria",3,1728,0,0,0,1728,1656,0,0,0,1656
"006","Alessandria",4,1678,0,0,0,1678,1669,0,0,0,1669
"006","Alessandria",5,1692,0,0,0,1692,1641,0,0,0,1641
"006","Alessandria",6,1677,0,0,0,1677,1518,0,0,0,1518
"006","Alessandria",7,1655,0,0,0,1655,1652,0,0,0,1652
"006","Alessandria",8,1665,0,0,0,1665,1549,0,0,0,1549
"006","Alessandria",9,1603,0,0,0,1603,1587,0,0,0,1587
"006","Alessandria",10,1720,0,0,0,1720,1559,0,0,0,1559
"006","Alessandria",11,1658,0,0,0,1658,1599,0,0,0,1599
"006","Alessandria",12,1741,0,0,0,1741,1563,0,0,0,1563
"006","Alessandria",13,1608,0,0,0,1608,1571,0,0,0,1571
"006","Alessandria",14,1687,0,0,0,1687,1603,0,0,0,1603
"006","Alessandria",15,1681,0,0,0,1681,1545,0,0,0,1545
"006","Alessandria",16,1645,0,0,0,1645,1574,0,0,0,1574
"006","Alessandria",17,1696,0,0,0,1696,1629,0,0,0,1629
"006","Alessandria",18,1717,0,0,0,1717,1659,8,0,0,1667
"006","Alessandria",19,1756,0,0,0,1756,1661,36,1,0,1698
"006","Alessandria",20,1736,4,2,0,1742,1638,57,0,0,1695
"006","Alessandria",21,1845,9,1,0,1855,1576,93,3,0,1672
"006","Alessandria",22,1758,16,0,0,1774,1557,179,0,0,1736
"006","Alessandria",23,1743,42,2,1,1788,1576,261,4,0,1841
"006","Alessandria",24,1696,91,3,1,1791,1434,304,3,2,1743
"006","Alessandria",25,1724,100,1,0,1825,1444,386,3,3,1836
"006","Alessandria",26,1742,174,5,0,1921,1376,482,6,3,1867
"006","Alessandria",27,1688,202,1,0,1891,1364,617,13,2,1996
"006","Alessandria",28,1691,333,2,1,2027,1319,697,12,5,2033
"006","Alessandria",29,1720,420,6,0,2146,1293,840,14,6,2153
"006","Alessandria",30,1565,557,5,1,2128,1147,949,21,6,2123
"006","Alessandria",31,1555,671,10,1,2237,1054,1085,36,8,2183
"006","Alessandria",32,1444,769,6,2,2221,1045,1182,29,3,2259
"006","Alessandria",33,1539,966,19,5,2529,998,1455,48,8,2509
"006","Alessandria",34,1572,1114,22,1,2709,1080,1562,69,11,2722
"006","Alessandria",35,1581,1248,30,0,2859,1039,1712,70,17,2838
"006","Alessandria",36,1528,1413,38,3,2982,988,1860,90,18,2956
"006","Alessandria",37,1500,1521,48,6,3075,937,1893,113,14,2957
"006","Alessandria",38,1411,1534,61,5,3011,909,1979,139,26,3053
"006","Alessandria",39,1385,1785,72,6,3248,910,2061,140,40,3151
"006","Alessandria",40,1324,1872,83,15,3294,838,2315,158,28,3339
"006","Alessandria",41,1180,2031,103,14,3328,721,2275,184,47,3227
"006","Alessandria",42,1170,2112,113,12,3407,793,2466,210,52,3521
"006","Alessandria",43,1069,2148,145,13,3375,642,2436,229,58,3365
"006","Alessandria",44,1083,2295,172,19,3569,616,2573,238,60,3487
"006","Alessandria",45,1024,2339,159,18,3540,578,2588,248,78,3492
"006","Alessandria",46,949,2442,205,24,3620,580,2602,291,65,3538
"006","Alessandria",47,852,2526,196,29,3603,567,2767,282,89,3705
"006","Alessandria",48,671,2484,229,36,3420,475,2527,266,83,3351
"006","Alessandria",49,659,2323,189,36,3207,452,2462,283,114,3311
"006","Alessandria",50,636,2399,194,43,3272,453,2429,306,124,3312
"006","Alessandria",51,598,2287,200,38,3123,381,2327,252,122,3082
"006","Alessandria",52,534,2271,190,34,3029,349,2303,287,139,3078
"006","Alessandria",53,487,2252,192,63,2994,317,2364,281,170,3132
"006","Alessandria",54,467,2379,194,38,3078,320,2285,218,151,2974
"006","Alessandria",55,428,2308,177,45,2958,241,2310,260,156,2967
"006","Alessandria",56,381,2287,171,44,2883,244,2277,227,192,2940
"006","Alessandria",57,365,2201,180,54,2800,219,2234,238,218,2909
"006","Alessandria",58,316,2177,176,57,2726,229,2131,185,229,2774
"006","Alessandria",59,350,2175,157,64,2746,233,2085,169,261,2748
"006","Alessandria",60,309,2213,149,76,2747,207,2200,156,272,2835
"006","Alessandria",61,289,2234,149,72,2744,214,2284,190,361,3049
"006","Alessandria",62,319,2333,153,73,2878,179,2198,163,381,2921
"006","Alessandria",63,319,2447,136,85,2987,202,2277,170,454,3103
"006","Alessandria",64,316,2380,141,123,2960,199,2346,174,484,3203
"006","Alessandria",65,289,2409,148,139,2985,169,2303,158,530,3160
"006","Alessandria",66,209,1778,97,105,2189,152,1741,81,439,2413
"006","Alessandria",67,227,1953,103,133,2416,166,1835,92,546,2639
"006","Alessandria",68,234,1935,76,158,2403,168,1797,99,606,2670
"006","Alessandria",69,223,1980,82,133,2418,176,1802,116,670,2764
"006","Alessandria",70,245,1979,85,159,2468,163,1787,88,772,2810
"006","Alessandria",71,237,2091,77,201,2606,204,1797,93,925,3019
"006","Alessandria",72,247,2092,65,203,2607,163,1843,79,982,3067
"006","Alessandria",73,254,2049,81,227,2611,152,1669,88,1115,3024
"006","Alessandria",74,207,1798,48,230,2283,154,1457,62,1077,2750
"006","Alessandria",75,187,1738,36,212,2173,172,1324,42,1126,2664
"006","Alessandria",76,222,1577,44,243,2086,179,1225,60,1192,2656
"006","Alessandria",77,187,1470,39,282,1978,172,1102,37,1275,2586
"006","Alessandria",78,200,1385,35,252,1872,180,1048,35,1403,2666
"006","Alessandria",79,175,1276,28,239,1718,198,898,45,1412,2553
"006","Alessandria",80,166,1175,23,243,1607,189,783,29,1441,2442
"006","Alessandria",81,154,1185,16,270,1625,199,690,43,1582,2514
"006","Alessandria",82,151,1042,23,252,1468,148,629,27,1516,2320
"006","Alessandria",83,116,892,21,264,1293,186,503,24,1490,2203
"006","Alessandria",84,111,759,13,271,1154,166,376,27,1486,2055
"006","Alessandria",85,94,650,12,241,997,159,333,17,1359,1868
"006","Alessandria",86,93,566,7,234,900,148,265,12,1330,1755
"006","Alessandria",87,70,455,5,235,765,151,193,21,1235,1600
"006","Alessandria",88,59,343,4,222,628,124,126,13,1197,1460
"006","Alessandria",89,48,265,3,183,499,114,120,9,1080,1323
"006","Alessandria",90,30,231,6,188,455,90,68,11,995,1164
"006","Alessandria",91,37,181,2,146,366,81,39,7,838,965
"006","Alessandria",92,19,73,1,70,163,44,19,2,450,515
"006","Alessandria",93,11,47,0,41,99,32,19,3,275,329
"006","Alessandria",94,5,30,0,53,88,26,9,0,253,288
"006","Alessandria",95,6,27,3,45,81,19,6,0,237,262
"006","Alessandria",96,9,39,0,42,90,32,4,2,257,295
"006","Alessandria",97,6,17,1,35,59,25,9,0,198,232
"006","Alessandria",98,6,13,0,19,38,12,5,3,149,169
"006","Alessandria",99,0,5,0,12,17,12,0,1,106,119
"006","Alessandria",100,5,9,0,16,30,21,2,1,142,166
"007","Valle d'Aosta/Vall√©e d'Aoste",0,626,0,0,0,626,588,0,0,0,588
"007","Valle d'Aosta/Vall√©e d'Aoste",1,588,0,0,0,588,603,0,0,0,603
"007","Valle d'Aosta/Vall√©e d'Aoste",2,658,0,0,0,658,602,0,0,0,602
"007","Valle d'Aosta/Vall√©e d'Aoste",3,625,0,0,0,625,609,0,0,0,609
"007","Valle d'Aosta/Vall√©e d'Aoste",4,646,0,0,0,646,594,0,0,0,594
"007","Valle d'Aosta/Vall√©e d'Aoste",5,666,0,0,0,666,594,0,0,0,594
"007","Valle d'Aosta/Vall√©e d'Aoste",6,588,0,0,0,588,577,0,0,0,577
"007","Valle d'Aosta/Vall√©e d'Aoste",7,581,0,0,0,581,582,0,0,0,582
"007","Valle d'Aosta/Vall√©e d'Aoste",8,588,0,0,0,588,595,0,0,0,595
"007","Valle d'Aosta/Vall√©e d'Aoste",9,605,0,0,0,605,524,0,0,0,524
"007","Valle d'Aosta/Vall√©e d'Aoste",10,629,0,0,0,629,561,0,0,0,561
"007","Valle d'Aosta/Vall√©e d'Aoste",11,620,0,0,0,620,588,0,0,0,588
"007","Valle d'Aosta/Vall√©e d'Aoste",12,602,0,0,0,602,563,0,0,0,563
"007","Valle d'Aosta/Vall√©e d'Aoste",13,571,0,0,0,571,547,0,0,0,547
"007","Valle d'Aosta/Vall√©e d'Aoste",14,535,0,0,0,535,519,0,0,0,519
"007","Valle d'Aosta/Vall√©e d'Aoste",15,594,0,0,0,594,554,0,0,0,554
"007","Valle d'Aosta/Vall√©e d'Aoste",16,555,0,0,0,555,508,0,0,0,508
"007","Valle d'Aosta/Vall√©e d'Aoste",17,538,0,0,0,538,513,0,0,0,513
"007","Valle d'Aosta/Vall√©e d'Aoste",18,528,0,0,0,528,514,1,0,0,515
"007","Valle d'Aosta/Vall√©e d'Aoste",19,593,1,0,0,594,516,6,0,0,522
"007","Valle d'Aosta/Vall√©e d'Aoste",20,566,2,0,0,568,517,19,0,0,536
"007","Valle d'Aosta/Vall√©e d'Aoste",21,563,0,0,0,563,568,33,0,0,601
"007","Valle d'Aosta/Vall√©e d'Aoste",22,596,8,1,0,605,476,46,0,0,522
"007","Valle d'Aosta/Vall√©e d'Aoste",23,602,15,0,0,617,513,64,0,0,577
"007","Valle d'Aosta/Vall√©e d'Aoste",24,586,26,0,0,612,502,101,1,0,604
"007","Valle d'Aosta/Vall√©e d'Aoste",25,546,44,2,0,592,526,122,4,0,652
"007","Valle d'Aosta/Vall√©e d'Aoste",26,587,59,0,0,646,472,131,2,0,605
"007","Valle d'Aosta/Vall√©e d'Aoste",27,564,80,2,0,646,456,174,6,0,636
"007","Valle d'Aosta/Vall√©e d'Aoste",28,589,135,0,0,724,439,221,4,1,665
"007","Valle d'Aosta/Vall√©e d'Aoste",29,522,151,1,0,674,431,284,4,3,722
"007","Valle d'Aosta/Vall√©e d'Aoste",30,497,164,1,0,662,360,293,9,1,663
"007","Valle d'Aosta/Vall√©e d'Aoste",31,536,227,4,0,767,362,329,9,1,701
"007","Valle d'Aosta/Vall√©e d'Aoste",32,456,268,7,0,731,335,340,10,4,689
"007","Valle d'Aosta/Vall√©e d'Aoste",33,587,307,2,0,896,373,448,13,0,834
"007","Valle d'Aosta/Vall√©e d'Aoste",34,476,354,5,0,835,354,424,25,3,806
"007","Valle d'Aosta/Vall√©e d'Aoste",35,488,355,12,1,856,361,503,30,3,897
"007","Valle d'Aosta/Vall√©e d'Aoste",36,528,382,16,0,926,370,552,35,5,962
"007","Valle d'Aosta/Vall√©e d'Aoste",37,523,475,18,2,1018,361,559,42,3,965
"007","Valle d'Aosta/Vall√©e d'Aoste",38,435,526,27,1,989,348,594,52,6,1000
"007","Valle d'Aosta/Vall√©e d'Aoste",39,455,509,23,2,989,337,630,55,7,1029
"007","Valle d'Aosta/Vall√©e d'Aoste",40,411,575,34,1,1021,297,687,65,11,1060
"007","Valle d'Aosta/Vall√©e d'Aoste",41,408,591,34,1,1034,286,663,70,11,1030
"007","Valle d'Aosta/Vall√©e d'Aoste",42,406,644,56,2,1108,301,725,71,9,1106
"007","Valle d'Aosta/Vall√©e d'Aoste",43,392,637,44,4,1077,274,688,88,18,1068
"007","Valle d'Aosta/Vall√©e d'Aoste",44,364,650,52,6,1072,280,682,95,23,1080
"007","Valle d'Aosta/Vall√©e d'Aoste",45,369,667,74,2,1112,229,745,91,16,1081
"007","Valle d'Aosta/Vall√©e d'Aoste",46,305,699,58,4,1066,225,736,88,22,1071
"007","Valle d'Aosta/Vall√©e d'Aoste",47,332,755,78,7,1172,234,760,89,26,1109
"007","Valle d'Aosta/Vall√©e d'Aoste",48,269,714,80,10,1073,203,707,90,35,1035
"007","Valle d'Aosta/Vall√©e d'Aoste",49,223,661,70,8,962,162,703,84,29,978
"007","Valle d'Aosta/Vall√©e d'Aoste",50,252,688,77,5,1022,151,664,93,27,935
"007","Valle d'Aosta/Vall√©e d'Aoste",51,200,617,75,6,898,140,647,85,36,908
"007","Valle d'Aosta/Vall√©e d'Aoste",52,179,672,75,9,935,148,677,84,43,952
"007","Valle d'Aosta/Vall√©e d'Aoste",53,193,603,55,9,860,104,637,84,42,867
"007","Valle d'Aosta/Vall√©e d'Aoste",54,154,632,63,13,862,128,610,82,39,859
"007","Valle d'Aosta/Vall√©e d'Aoste",55,141,645,68,3,857,96,612,72,51,831
"007","Valle d'Aosta/Vall√©e d'Aoste",56,136,595,56,13,800,107,628,78,63,876
"007","Valle d'Aosta/Vall√©e d'Aoste",57,159,612,51,10,832,90,625,67,69,851
"007","Valle d'Aosta/Vall√©e d'Aoste",58,127,651,59,11,848,83,576,62,59,780
"007","Valle d'Aosta/Vall√©e d'Aoste",59,123,589,58,10,780,76,559,60,77,772
"007","Valle d'Aosta/Vall√©e d'Aoste",60,107,620,53,21,801,70,589,57,76,792
"007","Valle d'Aosta/Vall√©e d'Aoste",61,122,616,45,22,805,75,589,56,88,808
"007","Valle d'Aosta/Vall√©e d'Aoste",62,109,635,54,14,812,76,628,49,111,864
"007","Valle d'Aosta/Vall√©e d'Aoste",63,108,653,49,30,840,60,630,66,115,871
"007","Valle d'Aosta/Vall√©e d'Aoste",64,87,661,51,34,833,48,545,54,110,757
"007","Valle d'Aosta/Vall√©e d'Aoste",65,91,586,42,31,750,41,560,45,143,789
"007","Valle d'Aosta/Vall√©e d'Aoste",66,73,454,19,25,571,40,455,36,121,652
"007","Valle d'Aosta/Vall√©e d'Aoste",67,87,510,33,38,668,43,419,41,140,643
"007","Valle d'Aosta/Vall√©e d'Aoste",68,78,543,32,35,688,42,431,37,157,667
"007","Valle d'Aosta/Vall√©e d'Aoste",69,76,570,22,43,711,38,434,31,208,711
"007","Valle d'Aosta/Vall√©e d'Aoste",70,99,509,25,42,675,56,466,26,203,751
"007","Valle d'Aosta/Vall√©e d'Aoste",71,91,531,16,43,681,58,426,35,249,768
"007","Valle d'Aosta/Vall√©e d'Aoste",72,77,516,20,50,663,45,423,26,236,730
"007","Valle d'Aosta/Vall√©e d'Aoste",73,61,483,16,62,622,55,384,24,299,762
"007","Valle d'Aosta/Vall√©e d'Aoste",74,65,392,16,51,524,47,337,17,283,684
"007","Valle d'Aosta/Vall√©e d'Aoste",75,49,385,8,50,492,40,306,21,280,647
"007","Valle d'Aosta/Vall√©e d'Aoste",76,57,371,11,53,492,39,259,18,291,607
"007","Valle d'Aosta/Vall√©e d'Aoste",77,50,316,9,46,421,40,244,15,315,614
"007","Valle d'Aosta/Vall√©e d'Aoste",78,42,332,6,55,435,46,216,14,316,592
"007","Valle d'Aosta/Vall√©e d'Aoste",79,41,281,12,68,402,56,184,8,316,564
"007","Valle d'Aosta/Vall√©e d'Aoste",80,51,278,7,64,400,40,191,9,340,580
"007","Valle d'Aosta/Vall√©e d'Aoste",81,33,258,6,76,373,42,177,11,372,602
"007","Valle d'Aosta/Vall√©e d'Aoste",82,32,232,5,63,332,38,128,4,360,530
"007","Valle d'Aosta/Vall√©e d'Aoste",83,39,185,6,57,287,34,111,8,355,508
"007","Valle d'Aosta/Vall√©e d'Aoste",84,26,149,2,57,234,45,99,6,338,488
"007","Valle d'Aosta/Vall√©e d'Aoste",85,24,131,2,56,213,42,64,6,342,454
"007","Valle d'Aosta/Vall√©e d'Aoste",86,15,130,2,57,204,22,58,5,263,348
"007","Valle d'Aosta/Vall√©e d'Aoste",87,12,74,1,43,130,32,33,5,274,344
"007","Valle d'Aosta/Vall√©e d'Aoste",88,10,64,1,43,118,31,38,3,246,318
"007","Valle d'Aosta/Vall√©e d'Aoste",89,6,62,1,33,102,16,23,4,260,303
"007","Valle d'Aosta/Vall√©e d'Aoste",90,8,37,1,35,81,19,17,3,210,249
"007","Valle d'Aosta/Vall√©e d'Aoste",91,4,29,2,24,59,22,12,3,159,196
"007","Valle d'Aosta/Vall√©e d'Aoste",92,0,14,2,17,33,5,7,1,93,106
"007","Valle d'Aosta/Vall√©e d'Aoste",93,1,10,0,9,20,4,2,1,74,81
"007","Valle d'Aosta/Vall√©e d'Aoste",94,2,6,0,9,17,16,3,0,53,72
"007","Valle d'Aosta/Vall√©e d'Aoste",95,2,7,0,2,11,6,0,0,47,53
"007","Valle d'Aosta/Vall√©e d'Aoste",96,0,5,0,7,12,4,1,0,43,48
"007","Valle d'Aosta/Vall√©e d'Aoste",97,1,4,0,6,11,3,0,0,43,46
"007","Valle d'Aosta/Vall√©e d'Aoste",98,1,1,0,1,3,1,0,0,25,26
"007","Valle d'Aosta/Vall√©e d'Aoste",99,0,1,0,0,1,3,0,1,15,19
"007","Valle d'Aosta/Vall√©e d'Aoste",100,0,3,0,1,4,2,0,0,26,28
"008","Imperia",0,808,0,0,0,808,710,0,0,0,710
"008","Imperia",1,800,0,0,0,800,739,0,0,0,739
"008","Imperia",2,813,0,0,0,813,816,0,0,0,816
"008","Imperia",3,861,0,0,0,861,828,0,0,0,828
"008","Imperia",4,919,0,0,0,919,782,0,0,0,782
"008","Imperia",5,799,0,0,0,799,804,0,0,0,804
"008","Imperia",6,868,0,0,0,868,860,0,0,0,860
"008","Imperia",7,854,0,0,0,854,820,0,0,0,820
"008","Imperia",8,859,0,0,0,859,783,0,0,0,783
"008","Imperia",9,880,0,0,0,880,761,0,0,0,761
"008","Imperia",10,855,0,0,0,855,868,0,0,0,868
"008","Imperia",11,934,0,0,0,934,834,0,0,0,834
"008","Imperia",12,873,0,0,0,873,891,0,0,0,891
"008","Imperia",13,933,0,0,0,933,810,0,0,0,810
"008","Imperia",14,895,0,0,0,895,841,0,0,0,841
"008","Imperia",15,934,0,0,0,934,869,0,0,0,869
"008","Imperia",16,900,0,0,0,900,846,0,0,0,846
"008","Imperia",17,880,0,0,0,880,843,0,0,0,843
"008","Imperia",18,956,0,0,0,956,833,2,0,0,835
"008","Imperia",19,971,0,0,0,971,936,10,0,0,946
"008","Imperia",20,937,2,0,0,939,896,39,0,0,935
"008","Imperia",21,932,7,1,0,940,881,58,0,0,939
"008","Imperia",22,975,8,0,0,983,827,83,0,0,910
"008","Imperia",23,916,25,0,0,941,843,126,0,0,969
"008","Imperia",24,917,55,0,0,972,785,146,1,1,933
"008","Imperia",25,903,72,0,0,975,742,178,2,0,922
"008","Imperia",26,845,81,2,0,928,741,241,1,0,983
"008","Imperia",27,810,159,1,0,970,635,262,1,1,899
"008","Imperia",28,830,160,1,0,991,683,307,3,0,993
"008","Imperia",29,750,231,4,0,985,590,388,8,0,986
"008","Imperia",30,799,267,4,0,1070,573,440,17,3,1033
"008","Imperia",31,740,310,5,0,1055,583,480,11,0,1074
"008","Imperia",32,676,371,6,2,1055,494,519,16,4,1033
"008","Imperia",33,707,434,7,0,1148,590,615,25,4,1234
"008","Imperia",34,737,444,9,0,1190,562,670,22,7,1261
"008","Imperia",35,696,558,12,0,1266,515,767,42,2,1326
"008","Imperia",36,766,620,17,0,1403,467,820,48,4,1339
"008","Imperia",37,718,712,25,1,1456,542,910,56,11,1519
"008","Imperia",38,715,725,35,0,1475,458,928,76,8,1470
"008","Imperia",39,704,830,45,6,1585,468,1011,87,3,1569
"008","Imperia",40,661,821,56,3,1541,426,1019,98,10,1553
"008","Imperia",41,642,886,65,4,1597,433,1104,113,12,1662
"008","Imperia",42,586,989,67,6,1648,390,1120,116,17,1643
"008","Imperia",43,569,1085,72,4,1730,376,1167,127,24,1694
"008","Imperia",44,536,1056,93,3,1688,377,1208,167,30,1782
"008","Imperia",45,554,1089,107,5,1755,349,1229,141,40,1759
"008","Imperia",46,467,1167,124,10,1768,360,1300,149,38,1847
"008","Imperia",47,496,1188,112,4,1800,316,1371,169,37,1893
"008","Imperia",48,425,1122,117,8,1672,301,1205,166,40,1712
"008","Imperia",49,388,1153,109,10,1660,266,1243,187,41,1737
"008","Imperia",50,357,1132,141,10,1640,222,1198,148,48,1616
"008","Imperia",51,291,1177,134,16,1618,218,1154,167,59,1598
"008","Imperia",52,298,1098,121,19,1536,208,1201,167,62,1638
"008","Imperia",53,251,1011,119,24,1405,204,1114,171,67,1556
"008","Imperia",54,278,1097,119,14,1508,186,1143,150,79,1558
"008","Imperia",55,223,1047,119,19,1408,167,1084,147,64,1462
"008","Imperia",56,206,1041,100,16,1363,181,1032,139,93,1445
"008","Imperia",57,212,1025,117,19,1373,153,1054,124,92,1423
"008","Imperia",58,186,1028,104,27,1345,139,1062,147,98,1446
"008","Imperia",59,174,970,121,20,1285,137,997,118,114,1366
"008","Imperia",60,138,970,85,27,1220,118,1079,131,126,1454
"008","Imperia",61,154,999,87,31,1271,107,1083,110,152,1452
"008","Imperia",62,137,1070,92,40,1339,117,1131,110,188,1546
"008","Imperia",63,166,1139,106,47,1458,124,1145,111,224,1604
"008","Imperia",64,157,1191,101,51,1500,137,1156,135,229,1657
"008","Imperia",65,137,1119,99,52,1407,117,1166,125,249,1657
"008","Imperia",66,100,880,70,49,1099,76,876,75,236,1263
"008","Imperia",67,127,984,80,70,1261,90,923,79,275,1367
"008","Imperia",68,119,956,67,64,1206,90,908,74,272,1344
"008","Imperia",69,119,974,72,65,1230,90,909,88,353,1440
"008","Imperia",70,119,1008,58,106,1291,100,918,79,392,1489
"008","Imperia",71,117,1069,70,103,1359,116,1007,84,441,1648
"008","Imperia",72,107,993,74,97,1271,108,932,77,481,1598
"008","Imperia",73,98,1064,54,95,1311,96,859,80,512,1547
"008","Imperia",74,116,909,65,105,1195,97,840,83,511,1531
"008","Imperia",75,99,938,38,110,1185,100,719,59,532,1410
"008","Imperia",76,102,843,45,121,1111,103,635,54,606,1398
"008","Imperia",77,76,757,40,123,996,91,590,60,582,1323
"008","Imperia",78,75,786,24,123,1008,77,543,60,640,1320
"008","Imperia",79,67,673,22,125,887,113,508,45,647,1313
"008","Imperia",80,44,608,24,146,822,117,426,41,665,1249
"008","Imperia",81,75,662,28,166,931,106,405,50,783,1344
"008","Imperia",82,55,502,18,137,712,97,311,24,671,1103
"008","Imperia",83,52,426,20,149,647,92,265,34,701,1092
"008","Imperia",84,49,390,8,119,566,82,201,29,664,976
"008","Imperia",85,43,307,10,98,458,95,157,17,614,883
"008","Imperia",86,25,254,13,104,396,66,166,27,547,806
"008","Imperia",87,23,222,8,98,351,72,88,21,573,754
"008","Imperia",88,23,168,5,93,289,78,77,13,568,736
"008","Imperia",89,12,135,3,78,228,55,65,21,448,589
"008","Imperia",90,12,115,4,64,195,59,48,9,440,556
"008","Imperia",91,15,80,0,66,161,55,28,10,370,463
"008","Imperia",92,2,29,1,30,62,20,18,8,160,206
"008","Imperia",93,3,31,1,26,61,18,5,1,129,153
"008","Imperia",94,5,19,0,18,42,7,4,3,118,132
"008","Imperia",95,2,16,0,18,36,11,4,2,100,117
"008","Imperia",96,3,11,0,20,34,13,4,2,125,144
"008","Imperia",97,0,5,0,9,14,8,4,1,78,91
"008","Imperia",98,1,4,0,11,16,5,2,1,54,62
"008","Imperia",99,0,5,0,10,15,6,4,1,42,53
"008","Imperia",100,0,4,0,15,19,8,1,2,70,81
"009","Savona",0,974,0,0,0,974,977,0,0,0,977
"009","Savona",1,1069,0,0,0,1069,956,0,0,0,956
"009","Savona",2,1079,0,0,0,1079,1050,0,0,0,1050
"009","Savona",3,1110,0,0,0,1110,1056,0,0,0,1056
"009","Savona",4,1166,0,0,0,1166,1021,0,0,0,1021
"009","Savona",5,1108,0,0,0,1108,1062,0,0,0,1062
"009","Savona",6,1201,0,0,0,1201,1067,0,0,0,1067
"009","Savona",7,1134,0,0,0,1134,1109,0,0,0,1109
"009","Savona",8,1135,0,0,0,1135,1051,0,0,0,1051
"009","Savona",9,1142,0,0,0,1142,1089,0,0,0,1089
"009","Savona",10,1112,0,0,0,1112,1033,0,0,0,1033
"009","Savona",11,1136,0,0,0,1136,1112,0,0,0,1112
"009","Savona",12,1087,0,0,0,1087,1022,0,0,0,1022
"009","Savona",13,1075,0,0,0,1075,1074,0,0,0,1074
"009","Savona",14,1078,0,0,0,1078,1051,0,0,0,1051
"009","Savona",15,1092,0,0,0,1092,1022,0,0,0,1022
"009","Savona",16,1033,0,0,0,1033,997,0,0,0,997
"009","Savona",17,1043,0,0,0,1043,1078,0,0,0,1078
"009","Savona",18,1063,0,0,0,1063,1032,3,0,0,1035
"009","Savona",19,1217,3,0,0,1220,1061,15,0,0,1076
"009","Savona",20,1067,3,0,0,1070,1014,32,0,0,1046
"009","Savona",21,1195,7,0,0,1202,1046,36,0,0,1082
"009","Savona",22,1109,10,0,0,1119,1053,75,0,0,1128
"009","Savona",23,1176,12,0,0,1188,1004,111,1,0,1116
"009","Savona",24,1105,38,0,0,1143,895,147,2,0,1044
"009","Savona",25,1076,47,0,0,1123,912,174,0,0,1086
"009","Savona",26,1086,72,0,0,1158,923,240,1,1,1165
"009","Savona",27,1123,120,1,0,1244,924,318,1,1,1244
"009","Savona",28,1102,164,0,0,1266,855,357,3,0,1215
"009","Savona",29,1068,212,4,0,1284,811,420,8,1,1240
"009","Savona",30,1010,253,6,0,1269,824,482,12,0,1318
"009","Savona",31,968,298,3,0,1269,726,541,12,0,1279
"009","Savona",32,922,409,4,2,1337,762,642,17,2,1423
"009","Savona",33,962,483,4,0,1449,777,727,28,5,1537
"009","Savona",34,983,615,12,0,1610,717,899,38,10,1664
"009","Savona",35,1013,620,14,0,1647,736,943,48,2,1729
"009","Savona",36,1021,757,17,1,1796,740,1063,46,7,1856
"009","Savona",37,1014,925,32,1,1972,726,1191,64,9,1990
"009","Savona",38,987,931,37,1,1956,662,1232,84,11,1989
"009","Savona",39,950,1077,47,3,2077,651,1358,100,10,2119
"009","Savona",40,937,1145,61,6,2149,625,1419,119,20,2183
"009","Savona",41,884,1240,75,6,2205,627,1424,148,15,2214
"009","Savona",42,836,1344,85,3,2268,566,1578,158,19,2321
"009","Savona",43,811,1406,98,5,2320,626,1543,165,28,2362
"009","Savona",44,765,1388,115,4,2272,585,1552,198,34,2369
"009","Savona",45,680,1450,136,4,2270,534,1651,186,29,2400
"009","Savona",46,685,1566,158,11,2420,479,1694,208,47,2428
"009","Savona",47,632,1619,166,5,2422,461,1668,182,58,2369
"009","Savona",48,539,1655,146,4,2344,382,1625,201,50,2258
"009","Savona",49,522,1475,146,12,2155,364,1604,191,70,2229
"009","Savona",50,485,1466,143,12,2106,298,1629,212,61,2200
"009","Savona",51,377,1371,152,13,1913,318,1486,167,72,2043
"009","Savona",52,368,1432,124,13,1937,308,1529,196,75,2108
"009","Savona",53,346,1379,156,22,1903,262,1443,161,89,1955
"009","Savona",54,315,1391,113,18,1837,217,1414,181,93,1905
"009","Savona",55,310,1355,122,33,1820,250,1406,160,92,1908
"009","Savona",56,265,1389,124,24,1802,208,1360,179,129,1876
"009","Savona",57,269,1359,120,31,1779,203,1355,141,137,1836
"009","Savona",58,240,1300,135,26,1701,195,1351,135,123,1804
"009","Savona",59,217,1329,102,33,1681,178,1313,141,175,1807
"009","Savona",60,180,1297,108,31,1616,138,1416,134,156,1844
"009","Savona",61,192,1375,103,42,1712,151,1485,150,181,1967
"009","Savona",62,208,1418,96,41,1763,187,1485,124,230,2026
"009","Savona",63,209,1508,111,69,1897,134,1552,118,253,2057
"009","Savona",64,197,1560,99,56,1912,164,1682,130,282,2258
"009","Savona",65,190,1645,93,58,1986,154,1604,135,373,2266
"009","Savona",66,146,1216,77,74,1513,122,1254,90,319,1785
"009","Savona",67,152,1323,69,89,1633,129,1359,88,363,1939
"009","Savona",68,152,1309,60,89,1610,133,1270,91,409,1903
"009","Savona",69,143,1352,60,97,1652,143,1398,73,454,2068
"009","Savona",70,139,1427,65,95,1726,157,1305,92,505,2059
"009","Savona",71,162,1506,64,155,1887,121,1361,89,606,2177
"009","Savona",72,173,1456,62,134,1825,138,1268,80,649,2135
"009","Savona",73,175,1416,61,146,1798,155,1203,78,787,2223
"009","Savona",74,137,1312,44,154,1647,145,1123,67,727,2062
"009","Savona",75,123,1191,44,153,1511,113,982,54,733,1882
"009","Savona",76,112,1126,43,169,1450,130,917,55,810,1912
"009","Savona",77,124,1109,32,168,1433,134,771,45,870,1820
"009","Savona",78,99,974,36,167,1276,139,723,51,872,1785
"009","Savona",79,114,900,28,174,1216,149,649,43,944,1785
"009","Savona",80,89,853,19,193,1154,129,630,41,964,1764
"009","Savona",81,84,815,26,188,1113,154,486,29,1016,1685
"009","Savona",82,74,729,17,206,1026,103,454,21,954,1532
"009","Savona",83,78,637,13,163,891,123,354,25,912,1414
"009","Savona",84,58,538,18,158,772,102,327,26,896,1351
"009","Savona",85,53,424,9,202,688,95,209,20,931,1255
"009","Savona",86,50,386,12,154,602,111,181,17,841,1150
"009","Savona",87,38,310,6,147,501,102,137,14,772,1025
"009","Savona",88,43,254,8,124,429,92,117,14,728,951
"009","Savona",89,20,202,3,112,337,73,62,9,673,817
"009","Savona",90,16,172,2,120,310,65,50,1,599,715
"009","Savona",91,11,133,3,84,231,58,34,7,497,596
"009","Savona",92,8,56,0,49,113,29,12,16,291,348
"009","Savona",93,9,28,0,36,73,18,11,7,193,229
"009","Savona",94,3,18,0,29,50,20,6,3,169,198
"009","Savona",95,4,25,2,29,60,23,4,2,175,204
"009","Savona",96,3,11,0,20,34,16,3,2,154,175
"009","Savona",97,1,11,0,25,37,14,2,4,122,142
"009","Savona",98,0,4,0,9,13,10,4,0,80,94
"009","Savona",99,1,3,0,6,10,11,1,0,64,76
"009","Savona",100,0,5,0,13,18,7,2,0,94,103
"010","Genova",0,3178,0,0,0,3178,2999,0,0,0,2999
"010","Genova",1,3166,0,0,0,3166,3115,0,0,0,3115
"010","Genova",2,3404,0,0,0,3404,3276,0,0,0,3276
"010","Genova",3,3399,0,0,0,3399,3286,0,0,0,3286
"010","Genova",4,3306,0,0,0,3306,3222,0,0,0,3222
"010","Genova",5,3456,0,0,0,3456,3325,0,0,0,3325
"010","Genova",6,3353,0,0,0,3353,3145,0,0,0,3145
"010","Genova",7,3294,0,0,0,3294,3286,0,0,0,3286
"010","Genova",8,3387,0,0,0,3387,3175,0,0,0,3175
"010","Genova",9,3455,0,0,0,3455,3300,0,0,0,3300
"010","Genova",10,3494,0,0,0,3494,3252,0,0,0,3252
"010","Genova",11,3385,0,0,0,3385,3199,0,0,0,3199
"010","Genova",12,3416,0,0,0,3416,3197,0,0,0,3197
"010","Genova",13,3380,0,0,0,3380,3286,0,0,0,3286
"010","Genova",14,3442,0,0,0,3442,3175,0,0,0,3175
"010","Genova",15,3579,0,0,0,3579,3172,0,0,0,3172
"010","Genova",16,3389,0,0,0,3389,3240,0,0,0,3240
"010","Genova",17,3472,0,0,0,3472,3235,0,0,0,3235
"010","Genova",18,3540,1,0,0,3541,3288,8,0,0,3296
"010","Genova",19,3654,2,0,0,3656,3366,35,0,0,3401
"010","Genova",20,3713,4,0,0,3717,3417,76,0,0,3493
"010","Genova",21,3466,13,1,0,3480,3320,119,4,0,3443
"010","Genova",22,3475,31,2,0,3508,3390,188,8,0,3586
"010","Genova",23,3555,77,5,0,3637,3210,258,3,0,3471
"010","Genova",24,3515,96,1,0,3612,3118,365,5,0,3488
"010","Genova",25,3254,158,4,0,3416,2928,436,3,0,3367
"010","Genova",26,3415,203,2,0,3620,3056,596,6,2,3660
"010","Genova",27,3284,331,5,0,3620,2824,793,11,1,3629
"010","Genova",28,3268,467,5,0,3740,2727,1021,13,4,3765
"010","Genova",29,3110,672,4,1,3787,2494,1184,25,0,3703
"010","Genova",30,3125,857,11,1,3994,2504,1496,26,8,4034
"010","Genova",31,2898,974,5,0,3877,2300,1737,38,2,4077
"010","Genova",32,2800,1239,18,0,4057,2329,2037,59,7,4432
"010","Genova",33,2898,1463,28,1,4390,2240,2452,67,6,4765
"010","Genova",34,2930,1823,28,2,4783,2269,2697,101,11,5078
"010","Genova",35,2969,2090,57,2,5118,2130,2886,131,12,5159
"010","Genova",36,3030,2477,57,4,5568,2295,3223,178,20,5716
"010","Genova",37,2983,2731,106,6,5826,2223,3651,216,28,6118
"010","Genova",38,2954,3088,110,7,6159,2074,3898,239,25,6236
"010","Genova",39,2863,3369,158,3,6393,2132,4174,333,26,6665
"010","Genova",40,2755,3547,194,4,6500,2003,4176,322,37,6538
"010","Genova",41,2455,3680,246,13,6394,1834,4366,414,45,6659
"010","Genova",42,2415,3860,264,7,6546,1721,4482,449,72,6724
"010","Genova",43,2301,3935,303,19,6558,1677,4506,487,74,6744
"010","Genova",44,2140,3951,312,14,6417,1601,4719,506,80,6906
"010","Genova",45,2008,4413,392,29,6842,1450,4989,576,109,7124
"010","Genova",46,2023,4542,445,29,7039,1431,5102,646,123,7302
"010","Genova",47,1866,4755,448,37,7106,1438,5154,659,122,7373
"010","Genova",48,1607,4504,451,30,6592,1306,5069,629,163,7167
"010","Genova",49,1524,4510,455,37,6526,1172,4934,622,154,6882
"010","Genova",50,1360,4342,393,40,6135,1051,4736,587,193,6567
"010","Genova",51,1243,4378,402,39,6062,1021,4570,588,188,6367
"010","Genova",52,1152,4370,439,43,6004,989,4633,612,222,6456
"010","Genova",53,1044,4207,392,46,5689,916,4581,569,247,6313
"010","Genova",54,989,4307,426,47,5769,820,4442,588,284,6134
"010","Genova",55,928,4214,410,73,5625,763,4443,555,309,6070
"010","Genova",56,851,4016,361,84,5312,695,4317,522,358,5892
"010","Genova",57,815,4254,394,82,5545,711,4347,494,391,5943
"010","Genova",58,748,4096,368,80,5292,648,4205,447,493,5793
"010","Genova",59,703,3926,334,97,5060,555,4124,452,477,5608
"010","Genova",60,666,4057,322,134,5179,586,4131,395,499,5611
"010","Genova",61,706,4494,316,125,5641,586,4362,398,605,5951
"010","Genova",62,609,4408,323,147,5487,550,4468,424,685,6127
"010","Genova",63,628,4717,313,179,5837,574,4804,407,841,6626
"010","Genova",64,596,4933,308,194,6031,547,4743,443,973,6706
"010","Genova",65,584,4993,283,221,6081,511,5061,371,1067,7010
"010","Genova",66,475,3584,208,193,4460,365,3328,272,936,4901
"010","Genova",67,443,4028,212,228,4911,385,3859,270,1129,5643
"010","Genova",68,434,3960,182,261,4837,410,3719,270,1160,5559
"010","Genova",69,441,3892,184,279,4796,420,3657,277,1374,5728
"010","Genova",70,415,3966,190,312,4883,403,3832,272,1508,6015
"010","Genova",71,457,4301,179,349,5286,452,4004,246,1766,6468
"010","Genova",72,445,4226,141,429,5241,488,3844,255,2021,6608
"010","Genova",73,463,4138,149,436,5186,470,3647,250,2186,6553
"010","Genova",74,391,3742,128,423,4684,416,3173,198,2160,5947
"010","Genova",75,363,3391,103,422,4279,405,2744,186,2256,5591
"010","Genova",76,297,3323,88,481,4189,409,2692,169,2427,5697
"010","Genova",77,320,3039,86,503,3948,439,2289,125,2549,5402
"010","Genova",78,332,2898,68,479,3777,418,2173,147,2660,5398
"010","Genova",79,291,2682,68,523,3564,451,1970,142,2846,5409
"010","Genova",80,266,2625,62,547,3500,462,1770,117,2985,5334
"010","Genova",81,284,2425,59,596,3364,493,1654,125,3154,5426
"010","Genova",82,238,2181,50,560,3029,487,1325,98,3130,5040
"010","Genova",83,203,1903,37,550,2693,423,1054,86,3059,4622
"010","Genova",84,183,1641,31,490,2345,405,925,80,2853,4263
"010","Genova",85,135,1340,26,516,2017,379,759,60,2885,4083
"010","Genova",86,147,1169,25,471,1812,360,556,51,2651,3618
"010","Genova",87,112,922,17,416,1467,304,462,40,2436,3242
"010","Genova",88,88,820,12,432,1352,292,324,55,2283,2954
"010","Genova",89,77,625,13,365,1080,285,256,45,2151,2737
"010","Genova",90,50,495,9,337,891,204,185,27,1876,2292
"010","Genova",91,43,375,6,279,703,198,121,26,1541,1886
"010","Genova",92,20,169,2,147,338,121,51,13,901,1086
"010","Genova",93,23,122,2,112,259,92,26,8,656,782
"010","Genova",94,14,90,1,96,201,63,22,13,550,648
"010","Genova",95,10,68,6,65,149,75,15,1,551,642
"010","Genova",96,4,58,1,77,140,63,14,6,520,603
"010","Genova",97,10,35,1,63,109,52,11,1,418,482
"010","Genova",98,4,15,0,30,49,26,9,3,257,295
"010","Genova",99,2,10,0,32,44,25,2,1,197,225
"010","Genova",100,2,13,0,34,49,44,6,2,293,345
"011","La Spezia",0,815,0,0,0,815,765,0,0,0,765
"011","La Spezia",1,781,0,0,0,781,834,0,0,0,834
"011","La Spezia",2,852,0,0,0,852,821,0,0,0,821
"011","La Spezia",3,847,0,0,0,847,861,0,0,0,861
"011","La Spezia",4,900,0,0,0,900,793,0,0,0,793
"011","La Spezia",5,875,0,0,0,875,901,0,0,0,901
"011","La Spezia",6,871,0,0,0,871,768,0,0,0,768
"011","La Spezia",7,887,0,0,0,887,811,0,0,0,811
"011","La Spezia",8,853,0,0,0,853,790,0,0,0,790
"011","La Spezia",9,835,0,0,0,835,819,0,0,0,819
"011","La Spezia",10,814,0,0,0,814,889,0,0,0,889
"011","La Spezia",11,891,0,0,0,891,806,0,0,0,806
"011","La Spezia",12,880,0,0,0,880,757,0,0,0,757
"011","La Spezia",13,852,0,0,0,852,816,0,0,0,816
"011","La Spezia",14,838,0,0,0,838,847,0,0,0,847
"011","La Spezia",15,838,0,0,0,838,887,0,0,0,887
"011","La Spezia",16,858,0,0,0,858,816,2,0,0,818
"011","La Spezia",17,862,0,0,0,862,782,0,0,0,782
"011","La Spezia",18,880,0,0,0,880,778,2,0,0,780
"011","La Spezia",19,976,0,0,0,976,855,11,0,0,866
"011","La Spezia",20,878,1,0,0,879,808,16,0,0,824
"011","La Spezia",21,924,4,0,0,928,869,27,0,0,896
"011","La Spezia",22,882,4,0,0,886,880,35,0,0,915
"011","La Spezia",23,909,18,0,0,927,844,91,0,0,935
"011","La Spezia",24,866,23,1,0,890,747,111,2,0,860
"011","La Spezia",25,875,43,0,0,918,824,166,1,2,993
"011","La Spezia",26,894,65,0,0,959,755,224,2,1,982
"011","La Spezia",27,824,109,1,0,934,731,277,5,0,1013
"011","La Spezia",28,871,179,4,0,1054,648,293,1,2,944
"011","La Spezia",29,914,212,3,0,1129,664,395,11,2,1072
"011","La Spezia",30,824,270,2,0,1096,599,452,6,2,1059
"011","La Spezia",31,800,301,2,0,1103,535,483,13,1,1032
"011","La Spezia",32,808,390,5,0,1203,573,576,10,3,1162
"011","La Spezia",33,784,498,17,0,1299,552,672,25,7,1256
"011","La Spezia",34,803,532,7,0,1342,532,769,22,0,1323
"011","La Spezia",35,766,587,10,1,1364,554,812,25,3,1394
"011","La Spezia",36,784,668,16,0,1468,520,878,59,5,1462
"011","La Spezia",37,753,815,28,4,1600,499,999,57,6,1561
"011","La Spezia",38,737,833,34,2,1606,477,1093,70,5,1645
"011","La Spezia",39,689,889,48,1,1627,431,1125,63,11,1630
"011","La Spezia",40,671,972,51,1,1695,445,1176,94,11,1726
"011","La Spezia",41,633,946,63,4,1646,409,1164,96,11,1680
"011","La Spezia",42,590,1074,67,3,1734,403,1268,142,20,1833
"011","La Spezia",43,556,1133,87,4,1780,379,1283,110,18,1790
"011","La Spezia",44,513,1189,80,4,1786,362,1341,132,21,1856
"011","La Spezia",45,532,1311,85,5,1933,338,1407,147,31,1923
"011","La Spezia",46,476,1265,112,6,1859,300,1445,167,30,1942
"011","La Spezia",47,443,1445,132,7,2027,290,1407,169,41,1907
"011","La Spezia",48,393,1248,114,7,1762,251,1363,154,37,1805
"011","La Spezia",49,347,1246,98,13,1704,251,1336,141,56,1784
"011","La Spezia",50,336,1281,121,9,1747,220,1295,158,45,1718
"011","La Spezia",51,277,1190,100,13,1580,161,1267,145,63,1636
"011","La Spezia",52,236,1158,122,13,1529,148,1188,135,55,1526
"011","La Spezia",53,253,1157,100,12,1522,180,1188,120,65,1553
"011","La Spezia",54,233,1114,109,13,1469,147,1166,124,65,1502
"011","La Spezia",55,176,1166,100,11,1453,140,1148,124,90,1502
"011","La Spezia",56,194,1060,82,22,1358,126,1101,115,89,1431
"011","La Spezia",57,169,1053,77,14,1313,113,1148,105,108,1474
"011","La Spezia",58,147,1085,64,26,1322,99,1030,87,103,1319
"011","La Spezia",59,132,992,77,27,1228,80,1096,89,102,1367
"011","La Spezia",60,141,1010,75,20,1246,88,1072,88,132,1380
"011","La Spezia",61,139,1105,80,24,1348,89,1121,67,154,1431
"011","La Spezia",62,139,1167,67,48,1421,72,1227,78,186,1563
"011","La Spezia",63,156,1279,64,61,1560,89,1207,52,193,1541
"011","La Spezia",64,125,1261,69,51,1506,85,1277,68,256,1686
"011","La Spezia",65,141,1292,56,44,1533,84,1261,75,258,1678
"011","La Spezia",66,86,862,37,43,1028,62,869,46,208,1185
"011","La Spezia",67,95,1055,44,55,1249,67,1025,49,274,1415
"011","La Spezia",68,100,1025,37,53,1215,54,947,62,304,1367
"011","La Spezia",69,67,1043,55,60,1225,71,1028,44,332,1475
"011","La Spezia",70,88,1082,49,74,1293,70,1028,42,350,1490
"011","La Spezia",71,109,1151,36,93,1389,80,997,48,460,1585
"011","La Spezia",72,98,1096,28,88,1310,74,993,52,428,1547
"011","La Spezia",73,99,1050,26,95,1270,73,902,56,504,1535
"011","La Spezia",74,95,917,30,85,1127,79,782,45,531,1437
"011","La Spezia",75,80,851,25,92,1048,72,720,22,547,1361
"011","La Spezia",76,90,796,17,81,984,89,611,27,561,1288
"011","La Spezia",77,72,794,18,87,971,70,624,16,607,1317
"011","La Spezia",78,59,763,12,121,955,73,569,18,621,1281
"011","La Spezia",79,69,724,16,104,913,88,482,22,698,1290
"011","La Spezia",80,74,645,15,135,869,104,470,21,687,1282
"011","La Spezia",81,65,650,12,135,862,91,417,16,807,1331
"011","La Spezia",82,57,539,12,118,726,88,380,8,817,1293
"011","La Spezia",83,48,527,4,142,721,82,313,8,769,1172
"011","La Spezia",84,52,453,7,104,616,74,262,12,769,1117
"011","La Spezia",85,30,405,4,107,546,63,179,17,741,1000
"011","La Spezia",86,25,348,3,121,497,70,154,15,720,959
"011","La Spezia",87,23,255,3,116,397,59,114,7,705,885
"011","La Spezia",88,19,208,2,124,353,50,108,3,647,808
"011","La Spezia",89,11,173,0,101,285,43,63,3,624,733
"011","La Spezia",90,14,123,3,109,249,46,52,5,548,651
"011","La Spezia",91,6,102,1,77,186,33,31,8,501,573
"011","La Spezia",92,1,51,1,40,93,22,12,2,260,296
"011","La Spezia",93,7,39,0,31,77,15,9,1,184,209
"011","La Spezia",94,4,18,0,13,35,5,4,2,149,160
"011","La Spezia",95,4,25,0,15,44,11,4,0,130,145
"011","La Spezia",96,2,15,0,19,36,11,1,1,126,139
"011","La Spezia",97,0,11,1,17,29,6,3,1,107,117
"011","La Spezia",98,1,7,0,14,22,4,3,1,73,81
"011","La Spezia",99,0,2,0,8,10,5,2,0,53,60
"011","La Spezia",100,0,5,0,6,11,6,1,0,70,77
"012","Varese",0,4113,0,0,0,4113,3909,0,0,0,3909
"012","Varese",1,4235,0,0,0,4235,4020,0,0,0,4020
"012","Varese",2,4423,0,0,0,4423,4124,0,0,0,4124
"012","Varese",3,4348,0,0,0,4348,4078,0,0,0,4078
"012","Varese",4,4412,0,0,0,4412,3950,0,0,0,3950
"012","Varese",5,4292,0,0,0,4292,4231,0,0,0,4231
"012","Varese",6,4220,0,0,0,4220,3984,0,0,0,3984
"012","Varese",7,4227,0,0,0,4227,4055,0,0,0,4055
"012","Varese",8,4027,0,0,0,4027,3944,0,0,0,3944
"012","Varese",9,4112,0,0,0,4112,3890,0,0,0,3890
"012","Varese",10,4085,0,0,0,4085,3830,0,0,0,3830
"012","Varese",11,4158,0,0,0,4158,3909,0,0,0,3909
"012","Varese",12,4022,0,0,0,4022,3933,0,0,0,3933
"012","Varese",13,3975,0,0,0,3975,3862,0,0,0,3862
"012","Varese",14,4042,0,0,0,4042,3728,0,0,0,3728
"012","Varese",15,4031,0,0,0,4031,3669,0,0,0,3669
"012","Varese",16,3825,0,0,0,3825,3697,0,0,0,3697
"012","Varese",17,3867,0,0,0,3867,3767,2,0,0,3769
"012","Varese",18,3988,0,0,0,3988,3807,13,0,0,3820
"012","Varese",19,4127,2,0,0,4129,3881,41,1,0,3923
"012","Varese",20,4196,6,0,0,4202,3741,101,0,0,3842
"012","Varese",21,4117,15,1,0,4133,3885,216,0,0,4101
"012","Varese",22,3985,45,0,0,4030,3759,293,2,1,4055
"012","Varese",23,4230,76,1,0,4307,3652,426,3,2,4083
"012","Varese",24,4150,130,4,0,4284,3453,558,3,0,4014
"012","Varese",25,3928,233,4,0,4165,3341,766,9,1,4117
"012","Varese",26,4156,335,3,0,4494,3501,980,13,1,4495
"012","Varese",27,4010,575,8,0,4593,3175,1254,13,2,4444
"012","Varese",28,4131,727,6,0,4864,3097,1619,22,7,4745
"012","Varese",29,3909,1065,9,0,4983,2962,1979,36,3,4980
"012","Varese",30,3713,1352,16,2,5083,2618,2336,27,2,4983
"012","Varese",31,3641,1574,14,0,5229,2481,2668,48,10,5207
"012","Varese",32,3518,1969,19,3,5509,2384,2975,60,6,5425
"012","Varese",33,3372,2470,46,3,5891,2269,3402,107,10,5788
"012","Varese",34,3367,2846,49,3,6265,2302,3706,111,14,6133
"012","Varese",35,3223,3192,60,4,6479,2178,4008,139,18,6343
"012","Varese",36,3348,3540,106,0,6994,2115,4441,188,17,6761
"012","Varese",37,3141,3890,111,9,7151,2045,4528,223,36,6832
"012","Varese",38,2997,3991,132,4,7124,1907,4690,263,29,6889
"012","Varese",39,2765,4336,168,12,7281,1802,5015,292,36,7145
"012","Varese",40,2616,4481,197,8,7302,1579,5016,338,59,6992
"012","Varese",41,2346,4562,247,18,7173,1487,5107,355,59,7008
"012","Varese",42,2117,4851,268,13,7249,1375,5365,422,60,7222
"012","Varese",43,2096,5145,254,15,7510,1304,5359,396,88,7147
"012","Varese",44,1902,5140,324,26,7392,1250,5429,399,100,7178
"012","Varese",45,1673,5356,336,15,7380,1103,5679,498,100,7380
"012","Varese",46,1565,5673,377,25,7640,1141,5820,499,155,7615
"012","Varese",47,1489,5607,359,34,7489,1007,5708,464,150,7329
"012","Varese",48,1305,5353,350,34,7042,901,5431,449,149,6930
"012","Varese",49,1092,5078,336,34,6540,824,5167,402,192,6585
"012","Varese",50,972,4846,349,49,6216,775,5042,436,187,6440
"012","Varese",51,895,4870,314,50,6129,724,4752,411,205,6092
"012","Varese",52,795,4695,308,51,5849,638,5013,401,240,6292
"012","Varese",53,698,4565,296,55,5614,655,4603,391,234,5883
"012","Varese",54,722,4524,287,63,5596,549,4535,331,280,5695
"012","Varese",55,616,4459,266,61,5402,556,4509,343,271,5679
"012","Varese",56,614,4415,271,68,5368,496,4623,324,281,5724
"012","Varese",57,558,4374,265,81,5278,474,4474,308,408,5664
"012","Varese",58,526,4314,225,111,5176,429,4388,281,402,5500
"012","Varese",59,501,4304,238,93,5136,427,4391,251,448,5517
"012","Varese",60,475,4319,214,109,5117,429,4302,243,510,5484
"012","Varese",61,487,4526,202,127,5342,407,4429,223,589,5648
"012","Varese",62,443,4496,179,166,5284,382,4635,246,675,5938
"012","Varese",63,431,4743,184,163,5521,373,4612,234,755,5974
"012","Varese",64,396,4509,202,178,5285,368,4377,236,815,5796
"012","Varese",65,403,4861,157,202,5623,374,4571,255,970,6170
"012","Varese",66,308,3527,124,171,4130,281,3303,162,819,4565
"012","Varese",67,321,3646,102,193,4262,311,3408,155,909,4783
"012","Varese",68,267,3672,102,225,4266,273,3342,140,974,4729
"012","Varese",69,272,3734,92,209,4307,272,3476,132,1114,4994
"012","Varese",70,331,3815,114,266,4526,349,3354,139,1246,5088
"012","Varese",71,314,4030,95,299,4738,359,3416,143,1546,5464
"012","Varese",72,294,4020,76,316,4706,371,3357,107,1725,5560
"012","Varese",73,260,3725,86,358,4429,372,2996,104,1795,5267
"012","Varese",74,246,3262,73,338,3919,366,2683,96,1770,4915
"012","Varese",75,194,2963,52,315,3524,298,2300,91,1739,4428
"012","Varese",76,194,2888,36,345,3463,326,2078,67,1987,4458
"012","Varese",77,193,2595,51,372,3211,358,1842,62,2074,4336
"012","Varese",78,148,2348,39,372,2907,336,1547,71,2043,3997
"012","Varese",79,161,2194,25,385,2765,331,1474,50,2169,4024
"012","Varese",80,157,2017,25,383,2582,333,1274,46,2146,3799
"012","Varese",81,126,1864,24,390,2404,341,1049,34,2306,3730
"012","Varese",82,122,1458,16,345,1941,290,873,39,2186,3388
"012","Varese",83,79,1353,24,360,1816,332,676,30,2176,3214
"012","Varese",84,75,1174,11,342,1602,305,590,40,2066,3001
"012","Varese",85,70,948,8,352,1378,284,472,32,2066,2854
"012","Varese",86,45,792,10,314,1161,228,340,18,1912,2498
"012","Varese",87,56,631,6,313,1006,228,275,11,1842,2356
"012","Varese",88,40,493,8,265,806,191,206,12,1645,2054
"012","Varese",89,28,412,0,218,658,180,144,12,1444,1780
"012","Varese",90,24,327,3,196,550,150,115,11,1244,1520
"012","Varese",91,23,213,2,145,383,126,60,9,1176,1371
"012","Varese",92,4,87,0,101,192,73,22,3,622,720
"012","Varese",93,2,58,0,39,99,44,24,1,373,442
"012","Varese",94,0,36,0,46,82,36,10,0,340,386
"012","Varese",95,2,40,0,38,80,32,9,1,326,368
"012","Varese",96,3,40,1,51,95,39,11,1,365,416
"012","Varese",97,2,22,1,39,64,38,2,2,265,307
"012","Varese",98,0,16,0,32,48,21,4,1,167,193
"012","Varese",99,1,8,0,24,33,11,3,0,109,123
"012","Varese",100,0,5,0,17,22,28,0,2,187,217
"013","Como",0,2781,0,0,0,2781,2638,0,0,0,2638
"013","Como",1,2868,0,0,0,2868,2743,0,0,0,2743
"013","Como",2,3075,0,0,0,3075,2742,0,0,0,2742
"013","Como",3,2961,0,0,0,2961,2846,0,0,0,2846
"013","Como",4,2897,0,0,0,2897,2801,0,0,0,2801
"013","Como",5,2956,0,0,0,2956,2791,0,0,0,2791
"013","Como",6,2949,0,0,0,2949,2758,0,0,0,2758
"013","Como",7,2897,0,0,0,2897,2752,0,0,0,2752
"013","Como",8,2831,0,0,0,2831,2648,0,0,0,2648
"013","Como",9,2665,0,0,0,2665,2589,0,0,0,2589
"013","Como",10,2888,0,0,0,2888,2619,0,0,0,2619
"013","Como",11,2912,0,0,0,2912,2687,0,0,0,2687
"013","Como",12,2756,0,0,0,2756,2730,0,0,0,2730
"013","Como",13,2853,0,0,0,2853,2543,0,0,0,2543
"013","Como",14,2764,0,0,0,2764,2672,0,0,0,2672
"013","Como",15,2740,0,0,0,2740,2567,0,0,0,2567
"013","Como",16,2661,0,0,0,2661,2620,0,0,0,2620
"013","Como",17,2738,0,0,0,2738,2545,1,0,0,2546
"013","Como",18,2788,1,0,0,2789,2476,5,0,0,2481
"013","Como",19,2763,5,0,0,2768,2524,26,0,1,2551
"013","Como",20,2760,2,0,0,2762,2652,62,0,0,2714
"013","Como",21,2857,11,0,0,2868,2541,122,0,0,2663
"013","Como",22,2762,20,0,0,2782,2538,188,0,1,2727
"013","Como",23,2810,51,0,0,2861,2428,279,1,0,2708
"013","Como",24,2708,90,1,0,2799,2322,364,2,0,2688
"013","Como",25,2713,140,0,0,2853,2343,497,3,0,2843
"013","Como",26,2813,218,1,0,3032,2319,684,7,1,3011
"013","Como",27,2658,359,1,0,3018,2208,853,9,1,3071
"013","Como",28,2757,483,4,0,3244,2202,1145,11,1,3359
"013","Como",29,2655,647,4,2,3308,2049,1300,10,4,3363
"013","Como",30,2555,836,11,0,3402,1820,1588,16,3,3427
"013","Como",31,2579,1053,10,0,3642,1708,1682,30,8,3428
"013","Como",32,2453,1326,15,0,3794,1661,1998,34,8,3701
"013","Como",33,2335,1648,27,1,4011,1518,2289,65,10,3882
"013","Como",34,2371,1836,27,1,4235,1614,2460,72,11,4157
"013","Como",35,2349,2124,33,2,4508,1504,2736,95,16,4351
"013","Como",36,2391,2403,60,2,4856,1496,2963,126,25,4610
"013","Como",37,2294,2621,68,4,4987,1404,3167,170,18,4759
"013","Como",38,2047,2740,88,6,4881,1314,3242,159,24,4739
"013","Como",39,1967,2953,102,9,5031,1208,3326,211,34,4779
"013","Como",40,1824,3148,136,2,5110,1139,3351,196,29,4715
"013","Como",41,1622,3008,167,8,4805,1039,3397,223,39,4698
"013","Como",42,1587,3326,179,10,5102,1023,3707,231,58,5019
"013","Como",43,1515,3356,176,13,5060,987,3617,250,57,4911
"013","Como",44,1348,3604,211,5,5168,915,3661,271,61,4908
"013","Como",45,1288,3807,190,14,5299,881,3780,277,65,5003
"013","Como",46,1168,3705,235,14,5122,844,3813,285,67,5009
"013","Como",47,1095,3833,225,7,5160,767,3835,295,104,5001
"013","Como",48,930,3444,233,23,4630,693,3653,301,118,4765
"013","Como",49,867,3384,209,32,4492,632,3316,274,97,4319
"013","Como",50,738,3418,200,26,4382,614,3316,278,112,4320
"013","Como",51,679,3204,220,24,4127,538,3355,247,130,4270
"013","Como",52,626,3244,207,40,4117,510,3182,261,168,4121
"013","Como",53,542,3049,195,38,3824,453,3020,232,165,3870
"013","Como",54,535,3022,162,44,3763,416,3106,227,178,3927
"013","Como",55,446,2973,221,50,3690,438,3043,216,211,3908
"013","Como",56,453,2859,155,47,3514,409,3012,175,207,3803
"013","Como",57,441,2834,158,49,3482,385,2890,198,234,3707
"013","Como",58,416,2897,144,62,3519,330,2892,171,269,3662
"013","Como",59,396,2919,152,64,3531,366,2978,156,292,3792
"013","Como",60,378,2943,149,73,3543,300,2900,170,305,3675
"013","Como",61,352,2956,119,85,3512,327,3001,156,389,3873
"013","Como",62,350,3167,141,86,3744,328,2936,178,423,3865
"013","Como",63,368,3173,141,95,3777,326,2956,155,533,3970
"013","Como",64,321,3089,107,123,3640,317,2817,137,543,3814
"013","Como",65,333,3056,119,133,3641,318,2927,137,628,4010
"013","Como",66,213,2379,73,116,2781,221,2063,101,472,2857
"013","Como",67,219,2407,88,130,2844,220,2133,121,593,3067
"013","Como",68,229,2314,69,138,2750,243,2097,85,652,3077
"013","Como",69,236,2311,63,157,2767,228,2066,66,683,3043
"013","Como",70,213,2365,58,193,2829,211,2122,68,830,3231
"013","Como",71,248,2688,60,223,3219,272,2143,81,990,3486
"013","Como",72,215,2435,59,200,2909,244,2110,70,1046,3470
"013","Como",73,223,2339,48,220,2830,255,1903,57,1146,3361
"013","Como",74,180,2082,38,209,2509,267,1591,52,1125,3035
"013","Como",75,159,1938,46,228,2371,262,1413,56,1081,2812
"013","Como",76,168,1803,24,243,2238,260,1308,41,1232,2841
"013","Como",77,141,1617,33,246,2037,278,1219,37,1311,2845
"013","Como",78,131,1479,28,243,1881,241,1016,24,1353,2634
"013","Como",79,125,1424,19,268,1836,275,884,38,1437,2634
"013","Como",80,124,1297,20,223,1664,267,792,35,1424,2518
"013","Como",81,91,1218,10,276,1595,289,681,34,1562,2566
"013","Como",82,95,974,7,262,1338,273,547,24,1472,2316
"013","Como",83,81,889,7,236,1213,273,464,24,1413,2174
"013","Como",84,70,715,6,218,1009,224,360,17,1341,1942
"013","Como",85,58,573,5,221,857,221,245,16,1269,1751
"013","Como",86,44,459,2,201,706,196,237,18,1170,1621
"013","Como",87,40,388,5,209,642,159,160,15,1157,1491
"013","Como",88,28,323,3,183,537,192,108,16,1041,1357
"013","Como",89,31,228,2,142,403,150,81,11,956,1198
"013","Como",90,24,193,0,127,344,141,63,7,857,1068
"013","Como",91,13,138,4,97,252,93,50,8,697,848
"013","Como",92,7,69,2,53,131,77,20,3,374,474
"013","Como",93,1,39,1,25,66,38,10,4,246,298
"013","Como",94,3,27,0,21,51,30,7,2,222,261
"013","Como",95,4,24,0,21,49,29,5,2,225,261
"013","Como",96,2,26,2,36,66,50,3,0,189,242
"013","Como",97,2,12,0,18,32,30,0,0,160,190
"013","Como",98,1,10,1,12,24,15,1,0,130,146
"013","Como",99,0,5,0,7,12,9,0,0,95,104
"013","Como",100,2,1,0,14,17,25,0,0,126,151
"014","Sondrio",0,840,0,0,0,840,759,0,0,0,759
"014","Sondrio",1,849,0,0,0,849,759,0,0,0,759
"014","Sondrio",2,782,0,0,0,782,754,0,0,0,754
"014","Sondrio",3,885,0,0,0,885,787,0,0,0,787
"014","Sondrio",4,827,0,0,0,827,775,0,0,0,775
"014","Sondrio",5,885,0,0,0,885,828,0,0,0,828
"014","Sondrio",6,831,0,0,0,831,810,0,0,0,810
"014","Sondrio",7,826,0,0,0,826,831,0,0,0,831
"014","Sondrio",8,855,0,0,0,855,844,0,0,0,844
"014","Sondrio",9,883,0,0,0,883,812,0,0,0,812
"014","Sondrio",10,835,0,0,0,835,820,0,0,0,820
"014","Sondrio",11,903,0,0,0,903,883,0,0,0,883
"014","Sondrio",12,885,0,0,0,885,845,0,0,0,845
"014","Sondrio",13,896,0,0,0,896,845,0,0,0,845
"014","Sondrio",14,912,0,0,0,912,865,0,0,0,865
"014","Sondrio",15,928,0,0,0,928,905,0,0,0,905
"014","Sondrio",16,938,0,0,0,938,805,0,0,0,805
"014","Sondrio",17,864,0,0,0,864,812,0,0,0,812
"014","Sondrio",18,889,0,0,0,889,854,4,0,0,858
"014","Sondrio",19,913,1,0,0,914,860,10,0,0,870
"014","Sondrio",20,933,1,0,0,934,832,20,0,0,852
"014","Sondrio",21,923,6,0,0,929,865,27,1,0,893
"014","Sondrio",22,900,7,0,0,907,797,51,0,0,848
"014","Sondrio",23,899,12,0,0,911,822,96,2,0,920
"014","Sondrio",24,867,25,0,0,892,791,110,0,0,901
"014","Sondrio",25,909,53,2,0,964,750,159,0,1,910
"014","Sondrio",26,874,90,1,0,965,721,230,1,1,953
"014","Sondrio",27,894,117,0,0,1011,667,272,4,1,944
"014","Sondrio",28,864,167,2,0,1033,589,357,3,1,950
"014","Sondrio",29,853,223,1,0,1077,587,435,9,0,1031
"014","Sondrio",30,801,277,1,0,1079,546,450,7,0,1003
"014","Sondrio",31,774,348,3,1,1126,482,535,9,1,1027
"014","Sondrio",32,678,369,7,0,1054,429,605,12,3,1049
"014","Sondrio",33,714,476,5,2,1197,408,649,25,1,1083
"014","Sondrio",34,677,508,8,1,1194,428,706,17,2,1153
"014","Sondrio",35,664,588,12,0,1264,391,792,32,4,1219
"014","Sondrio",36,640,630,15,0,1285,409,875,34,6,1324
"014","Sondrio",37,639,732,19,2,1392,390,843,44,8,1285
"014","Sondrio",38,613,757,17,0,1387,347,958,35,13,1353
"014","Sondrio",39,591,795,23,1,1410,344,939,53,6,1342
"014","Sondrio",40,515,851,55,3,1424,325,1026,63,18,1432
"014","Sondrio",41,464,923,42,2,1431,302,1000,53,13,1368
"014","Sondrio",42,492,905,50,6,1453,325,1062,66,24,1477
"014","Sondrio",43,499,960,53,4,1516,276,1084,86,15,1461
"014","Sondrio",44,442,1017,46,9,1514,249,1118,74,24,1465
"014","Sondrio",45,400,1075,60,9,1544,278,1140,81,24,1523
"014","Sondrio",46,424,1049,74,3,1550,232,1144,86,29,1491
"014","Sondrio",47,367,1121,71,7,1566,250,1154,93,44,1541
"014","Sondrio",48,319,1123,70,5,1517,220,1141,79,42,1482
"014","Sondrio",49,270,1033,67,6,1376,192,1106,79,47,1424
"014","Sondrio",50,284,1018,71,8,1381,198,1115,91,51,1455
"014","Sondrio",51,272,1002,62,11,1347,188,1059,91,58,1396
"014","Sondrio",52,263,999,73,14,1349,171,1078,67,76,1392
"014","Sondrio",53,212,997,73,13,1295,169,1004,59,76,1308
"014","Sondrio",54,193,987,54,17,1251,142,956,67,82,1247
"014","Sondrio",55,234,929,70,15,1248,148,923,75,74,1220
"014","Sondrio",56,193,898,46,22,1159,133,940,58,85,1216
"014","Sondrio",57,183,914,71,16,1184,129,915,70,99,1213
"014","Sondrio",58,176,905,46,22,1149,123,870,60,102,1155
"014","Sondrio",59,166,881,43,19,1109,107,849,74,108,1138
"014","Sondrio",60,167,929,57,31,1184,106,885,44,136,1171
"014","Sondrio",61,155,969,48,19,1191,105,889,47,149,1190
"014","Sondrio",62,153,966,41,44,1204,90,804,31,163,1088
"014","Sondrio",63,134,923,34,40,1131,82,883,41,194,1200
"014","Sondrio",64,131,901,31,39,1102,98,797,35,194,1124
"014","Sondrio",65,151,880,36,53,1120,104,822,48,213,1187
"014","Sondrio",66,101,682,21,40,844,52,574,27,220,873
"014","Sondrio",67,109,722,28,40,899,55,619,31,229,934
"014","Sondrio",68,115,720,26,47,908,68,580,21,269,938
"014","Sondrio",69,96,733,10,48,887,82,598,26,260,966
"014","Sondrio",70,107,707,23,68,905,63,602,19,296,980
"014","Sondrio",71,128,745,17,56,946,73,595,26,343,1037
"014","Sondrio",72,120,690,17,77,904,87,553,16,385,1041
"014","Sondrio",73,105,664,10,69,848,71,544,17,347,979
"014","Sondrio",74,105,622,9,67,803,61,475,16,420,972
"014","Sondrio",75,76,579,11,73,739,75,400,17,399,891
"014","Sondrio",76,84,564,9,92,749,71,382,10,453,916
"014","Sondrio",77,78,490,5,74,647,71,341,13,439,864
"014","Sondrio",78,59,448,6,75,588,83,268,11,474,836
"014","Sondrio",79,53,430,0,72,555,75,285,8,494,862
"014","Sondrio",80,43,378,8,67,496,87,230,15,514,846
"014","Sondrio",81,53,337,3,85,478,71,210,8,532,821
"014","Sondrio",82,36,297,4,89,426,71,140,8,474,693
"014","Sondrio",83,25,255,1,70,351,58,146,2,470,676
"014","Sondrio",84,27,226,3,94,350,60,114,3,429,606
"014","Sondrio",85,23,189,1,60,273,57,99,4,459,619
"014","Sondrio",86,15,132,4,59,210,60,62,1,378,501
"014","Sondrio",87,8,133,1,51,193,63,48,7,394,512
"014","Sondrio",88,7,91,1,65,164,49,41,2,369,461
"014","Sondrio",89,9,61,0,31,101,48,29,2,312,391
"014","Sondrio",90,10,44,2,25,81,37,15,1,309,362
"014","Sondrio",91,6,39,0,37,82,15,11,1,218,245
"014","Sondrio",92,3,27,0,17,47,30,10,1,160,201
"014","Sondrio",93,3,8,0,9,20,11,6,0,92,109
"014","Sondrio",94,0,7,0,11,18,21,1,1,70,93
"014","Sondrio",95,1,7,0,11,19,13,1,0,72,86
"014","Sondrio",96,0,6,0,4,10,5,1,1,71,78
"014","Sondrio",97,1,7,0,8,16,8,1,0,60,69
"014","Sondrio",98,0,1,0,1,2,11,2,0,52,65
"014","Sondrio",99,0,0,0,5,5,0,1,0,28,29
"014","Sondrio",100,0,3,0,4,7,9,0,0,30,39
"015","Milano",0,14710,0,0,0,14710,13810,0,0,0,13810
"015","Milano",1,14687,0,0,0,14687,13698,0,0,0,13698
"015","Milano",2,14873,0,0,0,14873,14299,0,0,0,14299
"015","Milano",3,15088,0,0,0,15088,14394,0,0,0,14394
"015","Milano",4,14850,0,0,0,14850,14125,0,0,0,14125
"015","Milano",5,15103,0,0,0,15103,14155,0,0,0,14155
"015","Milano",6,14775,0,0,0,14775,13771,0,0,0,13771
"015","Milano",7,14555,0,0,0,14555,14060,0,0,0,14060
"015","Milano",8,14457,0,0,0,14457,13436,0,0,0,13436
"015","Milano",9,14008,0,0,0,14008,13213,0,0,0,13213
"015","Milano",10,14003,0,0,0,14003,13349,0,0,0,13349
"015","Milano",11,14122,0,0,0,14122,13284,0,0,0,13284
"015","Milano",12,13658,0,0,0,13658,12845,0,0,0,12845
"015","Milano",13,13531,0,0,0,13531,12583,0,0,0,12583
"015","Milano",14,13315,0,0,0,13315,12568,0,0,0,12568
"015","Milano",15,13325,0,0,0,13325,12483,0,0,0,12483
"015","Milano",16,12945,0,0,0,12945,11894,1,0,0,11895
"015","Milano",17,13104,0,0,0,13104,12072,1,0,0,12073
"015","Milano",18,13078,0,0,0,13078,12347,19,0,0,12366
"015","Milano",19,13509,7,0,0,13516,12543,72,1,0,12616
"015","Milano",20,13653,24,0,0,13677,12182,214,0,0,12396
"015","Milano",21,13505,43,0,0,13548,12417,389,1,0,12807
"015","Milano",22,13446,119,2,0,13567,12406,639,3,1,13049
"015","Milano",23,13819,224,2,0,14045,12197,1035,8,2,13242
"015","Milano",24,13200,382,4,0,13586,11627,1454,5,3,13089
"015","Milano",25,13238,623,2,0,13863,11452,1974,7,3,13436
"015","Milano",26,13369,952,5,1,14327,11442,2820,18,4,14284
"015","Milano",27,13339,1506,5,0,14850,11337,3583,24,9,14953
"015","Milano",28,13746,2148,10,1,15905,11198,4640,37,17,15892
"015","Milano",29,13841,2993,14,2,16850,10923,6079,57,20,17079
"015","Milano",30,13178,3965,28,1,17172,10285,7056,87,28,17456
"015","Milano",31,12814,4885,35,5,17739,9483,8112,122,28,17745
"015","Milano",32,12533,5960,54,6,18553,9223,9251,172,24,18670
"015","Milano",33,12462,7195,64,10,19731,9070,10324,231,29,19654
"015","Milano",34,12323,8389,99,10,20821,9032,11686,332,54,21104
"015","Milano",35,12054,9675,158,9,21896,8940,12856,395,56,22247
"015","Milano",36,12332,11174,210,16,23732,8993,14488,544,67,24092
"015","Milano",37,12249,12441,271,20,24981,9047,15498,625,100,25270
"015","Milano",38,11671,13463,370,25,25529,8567,16151,780,105,25603
"015","Milano",39,10832,14161,478,25,25496,8057,16881,961,113,26012
"015","Milano",40,10304,15300,559,32,26195,7375,17528,1059,153,26115
"015","Milano",41,9463,15692,677,40,25872,7052,17627,1175,176,26030
"015","Milano",42,9025,16567,757,40,26389,6717,18296,1304,198,26515
"015","Milano",43,8307,16813,877,47,26044,6260,18386,1417,247,26310
"015","Milano",44,7757,17039,909,61,25766,5901,18705,1486,294,26386
"015","Milano",45,7542,17846,1071,93,26552,5617,19130,1724,351,26822
"015","Milano",46,6883,18159,1155,87,26284,5262,19326,1748,445,26781
"015","Milano",47,6125,18538,1245,105,26013,5045,19254,1734,443,26476
"015","Milano",48,5297,17296,1180,122,23895,4361,18383,1754,485,24983
"015","Milano",49,4723,16566,1207,128,22624,3937,17630,1723,538,23828
"015","Milano",50,4332,16292,1155,156,21935,3592,17112,1626,581,22911
"015","Milano",51,3748,16123,1103,161,21135,3368,16568,1659,635,22230
"015","Milano",52,3425,15512,1099,147,20183,3115,16319,1628,728,21790
"015","Milano",53,3178,15120,1082,187,19567,2874,15658,1514,734,20780
"015","Milano",54,2879,15045,1020,203,19147,2699,15607,1562,896,20764
"015","Milano",55,2734,14880,982,240,18836,2529,15059,1463,1052,20103
"015","Milano",56,2382,14529,956,233,18100,2267,15175,1401,1111,19954
"015","Milano",57,2246,14407,966,265,17884,2096,14685,1355,1249,19385
"015","Milano",58,2112,13886,875,291,17164,1918,14286,1307,1348,18859
"015","Milano",59,1950,13751,849,292,16842,1895,14319,1281,1431,18926
"015","Milano",60,1785,13540,844,358,16527,1695,14259,1259,1668,18881
"015","Milano",61,1759,14326,744,457,17286,1671,14754,1245,1881,19551
"015","Milano",62,1771,14706,768,455,17700,1720,14979,1237,2126,20062
"015","Milano",63,1692,15744,782,557,18775,1679,15664,1284,2563,21190
"015","Milano",64,1599,15526,751,630,18506,1610,15452,1232,2849,21143
"015","Milano",65,1570,16281,771,793,19415,1602,15972,1264,3334,22172
"015","Milano",66,1115,12223,571,611,14520,1269,11712,904,2859,16744
"015","Milano",67,1227,12921,559,689,15396,1279,12567,930,3262,18038
"015","Milano",68,1113,12749,525,752,15139,1360,12014,858,3584,17816
"015","Milano",69,1158,12727,486,793,15164,1281,12079,887,4073,18320
"015","Milano",70,1105,13031,445,993,15574,1362,12007,806,4689,18864
"015","Milano",71,1161,14268,438,1159,17026,1474,12652,847,5569,20542
"015","Milano",72,1012,13875,431,1204,16522,1474,12153,682,5810,20119
"015","Milano",73,940,13192,345,1264,15741,1449,11055,679,6270,19453
"015","Milano",74,842,11762,312,1212,14128,1279,9707,563,6450,17999
"015","Milano",75,693,10551,247,1227,12718,1212,8254,558,6337,16361
"015","Milano",76,693,10295,220,1267,12475,1256,7830,482,7281,16849
"015","Milano",77,663,9489,169,1403,11724,1247,6944,428,7256,15875
"015","Milano",78,599,8546,177,1368,10690,1207,6146,390,7447,15190
"015","Milano",79,521,7894,167,1329,9911,1289,5420,362,7667,14738
"015","Milano",80,475,7300,129,1452,9356,1180,4636,305,7910,14031
"015","Milano",81,421,6631,121,1370,8543,1236,4131,314,8305,13986
"015","Milano",82,363,5667,100,1345,7475,1120,3254,250,7805,12429
"015","Milano",83,329,4856,71,1253,6509,1084,2624,256,7506,11470
"015","Milano",84,266,4066,74,1274,5680,959,2129,189,7205,10482
"015","Milano",85,229,3309,44,1150,4732,826,1640,183,6848,9497
"015","Milano",86,202,2663,38,1066,3969,865,1335,165,6562,8927
"015","Milano",87,150,2275,33,984,3442,783,1029,134,6054,8000
"015","Milano",88,121,1831,27,965,2944,666,745,124,5621,7156
"015","Milano",89,93,1363,25,784,2265,530,572,100,4822,6024
"015","Milano",90,81,1098,19,695,1893,488,384,91,4410,5373
"015","Milano",91,59,845,10,601,1515,363,286,67,3703,4419
"015","Milano",92,32,319,6,284,641,215,103,32,2155,2505
"015","Milano",93,14,215,3,186,418,160,68,14,1385,1627
"015","Milano",94,19,150,3,165,337,116,40,17,1143,1316
"015","Milano",95,15,136,6,160,317,116,37,17,1169,1339
"015","Milano",96,11,107,2,148,268,108,27,18,1128,1281
"015","Milano",97,7,60,4,126,197,100,24,6,842,972
"015","Milano",98,5,35,0,88,128,49,7,9,636,701
"015","Milano",99,3,23,1,51,78,47,6,2,452,507
"015","Milano",100,7,25,1,62,95,72,13,8,613,706
"016","Bergamo",0,5674,0,0,0,5674,5460,0,0,0,5460
"016","Bergamo",1,5914,0,0,0,5914,5632,0,0,0,5632
"016","Bergamo",2,6030,0,0,0,6030,5865,0,0,0,5865
"016","Bergamo",3,5995,0,0,0,5995,5777,0,0,0,5777
"016","Bergamo",4,5838,0,0,0,5838,5683,0,0,0,5683
"016","Bergamo",5,6023,0,0,0,6023,5620,0,0,0,5620
"016","Bergamo",6,5818,0,0,0,5818,5557,0,0,0,5557
"016","Bergamo",7,5749,0,0,0,5749,5579,0,0,0,5579
"016","Bergamo",8,5730,0,0,0,5730,5547,0,0,0,5547
"016","Bergamo",9,5721,0,0,0,5721,5400,0,0,0,5400
"016","Bergamo",10,5810,0,0,0,5810,5373,0,0,0,5373
"016","Bergamo",11,5701,0,0,0,5701,5585,0,0,0,5585
"016","Bergamo",12,5514,0,0,0,5514,5331,0,0,0,5331
"016","Bergamo",13,5632,0,0,0,5632,5245,0,0,0,5245
"016","Bergamo",14,5639,0,0,0,5639,5184,0,0,0,5184
"016","Bergamo",15,5266,0,0,0,5266,5127,0,0,0,5127
"016","Bergamo",16,5327,1,0,0,5328,5113,0,0,0,5113
"016","Bergamo",17,5203,0,0,0,5203,4977,3,0,0,4980
"016","Bergamo",18,5397,0,0,0,5397,4942,34,0,0,4976
"016","Bergamo",19,5605,1,0,0,5606,4988,77,0,0,5065
"016","Bergamo",20,5422,9,0,0,5431,5101,152,0,0,5253
"016","Bergamo",21,5506,31,0,0,5537,4912,329,5,0,5246
"016","Bergamo",22,5375,53,8,0,5436,4861,489,3,1,5354
"016","Bergamo",23,5635,121,10,2,5768,4894,659,2,0,5555
"016","Bergamo",24,5442,224,7,1,5674,4559,954,9,0,5522
"016","Bergamo",25,5192,342,12,0,5546,4223,1268,2,3,5496
"016","Bergamo",26,5262,492,16,2,5772,4229,1696,6,1,5932
"016","Bergamo",27,5384,758,16,2,6160,3933,2125,16,1,6075
"016","Bergamo",28,5062,1091,14,2,6169,3691,2634,21,6,6352
"016","Bergamo",29,5008,1547,15,2,6572,3306,3100,20,9,6435
"016","Bergamo",30,4835,1924,20,3,6782,3136,3334,42,12,6524
"016","Bergamo",31,4562,2369,31,2,6964,2885,3865,56,15,6821
"016","Bergamo",32,4211,2868,31,3,7113,2734,4276,67,11,7088
"016","Bergamo",33,4390,3379,49,3,7821,2652,4812,83,13,7560
"016","Bergamo",34,4139,3757,68,5,7969,2549,4998,146,17,7710
"016","Bergamo",35,4006,4347,74,8,8435,2293,5352,148,40,7833
"016","Bergamo",36,4160,4798,111,3,9072,2395,5932,193,38,8558
"016","Bergamo",37,3944,5248,151,7,9350,2247,5981,280,36,8544
"016","Bergamo",38,3547,5430,170,10,9157,2071,6304,297,42,8714
"016","Bergamo",39,3455,5764,218,8,9445,1940,6311,315,47,8613
"016","Bergamo",40,3083,5963,231,10,9287,1804,6424,323,57,8608
"016","Bergamo",41,2976,6217,249,18,9460,1633,6612,366,84,8695
"016","Bergamo",42,2853,6408,289,12,9562,1568,6677,448,87,8780
"016","Bergamo",43,2696,6506,294,22,9518,1445,6827,431,96,8799
"016","Bergamo",44,2402,6625,329,27,9383,1532,6947,375,143,8997
"016","Bergamo",45,2428,7032,360,36,9856,1407,7176,438,132,9153
"016","Bergamo",46,2216,7123,342,41,9722,1393,7205,425,159,9182
"016","Bergamo",47,2054,7332,410,35,9831,1236,7303,464,203,9206
"016","Bergamo",48,1776,6799,386,47,9008,1135,6904,431,192,8662
"016","Bergamo",49,1524,6566,372,42,8504,1008,6593,411,220,8232
"016","Bergamo",50,1399,6300,342,47,8088,958,6290,385,229,7862
"016","Bergamo",51,1288,6326,380,65,8059,873,6267,369,258,7767
"016","Bergamo",52,1139,6283,324,71,7817,877,6063,334,280,7554
"016","Bergamo",53,1146,6064,256,66,7532,773,5861,330,315,7279
"016","Bergamo",54,974,5759,278,93,7104,682,5544,289,333,6848
"016","Bergamo",55,893,5654,253,89,6889,687,5639,327,367,7020
"016","Bergamo",56,905,5546,235,83,6769,598,5512,260,427,6797
"016","Bergamo",57,784,5544,237,107,6672,564,5262,270,472,6568
"016","Bergamo",58,752,5361,225,131,6469,546,5203,249,508,6506
"016","Bergamo",59,734,5284,193,146,6357,544,5075,214,559,6392
"016","Bergamo",60,699,5229,186,138,6252,495,5164,225,599,6483
"016","Bergamo",61,758,5601,181,179,6719,511,5371,198,713,6793
"016","Bergamo",62,667,5629,176,189,6661,472,5235,171,853,6731
"016","Bergamo",63,665,5518,183,191,6557,472,5261,194,950,6877
"016","Bergamo",64,570,5315,156,204,6245,423,4760,161,982,6326
"016","Bergamo",65,558,5462,144,238,6402,440,4865,150,1100,6555
"016","Bergamo",66,427,4091,92,200,4810,359,3568,87,973,4987
"016","Bergamo",67,438,4290,102,237,5067,359,3784,89,1198,5430
"016","Bergamo",68,456,4038,86,237,4817,375,3624,106,1261,5366
"016","Bergamo",69,459,4220,92,303,5074,322,3687,95,1445,5549
"016","Bergamo",70,437,4142,71,308,4958,414,3425,84,1533,5456
"016","Bergamo",71,445,4392,82,382,5301,461,3708,79,1911,6159
"016","Bergamo",72,420,4211,74,388,5093,448,3313,80,1901,5742
"016","Bergamo",73,386,3927,62,452,4827,435,3006,70,2199,5710
"016","Bergamo",74,329,3388,54,385,4156,396,2571,53,2019,5039
"016","Bergamo",75,291,2953,26,375,3645,408,2245,40,1992,4685
"016","Bergamo",76,295,2944,39,446,3724,443,2128,48,2181,4800
"016","Bergamo",77,251,2682,28,402,3363,403,1856,38,2213,4510
"016","Bergamo",78,252,2383,20,411,3066,424,1565,28,2291,4308
"016","Bergamo",79,223,2229,19,470,2941,406,1462,35,2411,4314
"016","Bergamo",80,198,1971,15,449,2633,439,1222,24,2350,4035
"016","Bergamo",81,197,1886,12,471,2566,481,1070,26,2586,4163
"016","Bergamo",82,142,1539,13,420,2114,435,819,25,2400,3679
"016","Bergamo",83,118,1344,15,368,1845,405,686,12,2335,3438
"016","Bergamo",84,119,1185,5,367,1676,384,557,14,2297,3252
"016","Bergamo",85,87,856,5,377,1325,368,447,9,2024,2848
"016","Bergamo",86,81,738,6,330,1155,336,329,9,1993,2667
"016","Bergamo",87,50,573,6,326,955,304,231,8,1901,2444
"016","Bergamo",88,54,468,4,305,831,328,193,6,1671,2198
"016","Bergamo",89,29,327,1,228,585,237,138,5,1347,1727
"016","Bergamo",90,34,291,2,207,534,218,83,3,1333,1637
"016","Bergamo",91,10,177,3,147,337,182,54,3,983,1222
"016","Bergamo",92,14,86,0,78,178,113,32,0,647,792
"016","Bergamo",93,4,47,0,46,97,60,9,2,391,462
"016","Bergamo",94,4,42,0,38,84,60,8,1,306,375
"016","Bergamo",95,6,26,0,43,75,56,7,0,316,379
"016","Bergamo",96,6,20,0,44,70,56,3,0,286,345
"016","Bergamo",97,3,19,0,30,52,39,2,1,212,254
"016","Bergamo",98,2,6,0,25,33,28,0,1,153,182
"016","Bergamo",99,1,4,0,15,20,16,1,0,91,108
"016","Bergamo",100,1,3,0,18,22,29,0,0,130,159
"017","Brescia",0,6475,0,0,0,6475,6056,0,0,0,6056
"017","Brescia",1,6847,0,0,0,6847,6360,0,0,0,6360
"017","Brescia",2,6794,0,0,0,6794,6484,0,0,0,6484
"017","Brescia",3,6867,0,0,0,6867,6511,0,0,0,6511
"017","Brescia",4,6872,0,0,0,6872,6505,0,0,0,6505
"017","Brescia",5,6787,0,0,0,6787,6467,0,0,0,6467
"017","Brescia",6,6442,0,0,0,6442,6164,0,0,0,6164
"017","Brescia",7,6465,0,0,0,6465,6262,0,0,0,6262
"017","Brescia",8,6382,0,0,0,6382,6067,0,0,0,6067
"017","Brescia",9,6313,0,0,0,6313,5915,0,0,0,5915
"017","Brescia",10,6487,0,0,0,6487,6056,0,0,0,6056
"017","Brescia",11,6393,0,0,0,6393,5995,0,0,0,5995
"017","Brescia",12,6223,0,0,0,6223,5915,0,0,0,5915
"017","Brescia",13,6216,0,0,0,6216,5868,0,0,0,5868
"017","Brescia",14,6056,0,0,0,6056,5722,0,0,0,5722
"017","Brescia",15,5976,0,0,0,5976,5627,0,0,0,5627
"017","Brescia",16,6023,1,0,0,6024,5567,1,0,0,5568
"017","Brescia",17,5882,0,0,0,5882,5494,3,0,0,5497
"017","Brescia",18,6136,1,0,0,6137,5576,22,0,0,5598
"017","Brescia",19,6156,4,0,0,6160,5523,87,0,0,5610
"017","Brescia",20,5960,10,0,0,5970,5475,241,1,0,5717
"017","Brescia",21,6154,36,0,0,6190,5501,391,0,0,5892
"017","Brescia",22,6168,79,0,0,6247,5193,595,2,1,5791
"017","Brescia",23,6264,165,0,0,6429,5250,869,5,0,6124
"017","Brescia",24,6031,261,1,0,6293,4976,1177,6,3,6162
"017","Brescia",25,5770,405,0,1,6176,4653,1571,5,0,6229
"017","Brescia",26,6088,652,2,0,6742,4646,1928,18,6,6598
"017","Brescia",27,6051,1012,1,0,7064,4386,2522,22,4,6934
"017","Brescia",28,5952,1316,5,1,7274,4112,3028,38,3,7181
"017","Brescia",29,5699,1780,8,0,7487,3975,3583,48,11,7617
"017","Brescia",30,5480,2222,10,3,7715,3689,4020,57,22,7788
"017","Brescia",31,5186,2760,15,3,7964,3524,4380,106,14,8024
"017","Brescia",32,4981,3116,22,2,8121,3228,4780,113,14,8135
"017","Brescia",33,4892,3873,44,1,8810,3130,5272,150,14,8566
"017","Brescia",34,4961,4292,83,3,9339,2866,5714,223,30,8833
"017","Brescia",35,4674,4693,98,3,9468,2896,6138,259,38,9331
"017","Brescia",36,4724,5623,120,3,10470,2855,6705,350,35,9945
"017","Brescia",37,4548,5985,210,9,10752,2802,6967,428,53,10250
"017","Brescia",38,4141,6141,231,13,10526,2471,6943,398,55,9867
"017","Brescia",39,3902,6562,266,10,10740,2323,7098,475,71,9967
"017","Brescia",40,3602,6724,319,20,10665,2199,7073,466,74,9812
"017","Brescia",41,3379,6992,390,16,10777,1979,7268,515,73,9835
"017","Brescia",42,3131,7382,385,16,10914,1933,7510,545,109,10097
"017","Brescia",43,2979,7477,388,20,10864,1837,7638,565,126,10166
"017","Brescia",44,2840,7497,456,38,10831,1852,7650,604,139,10245
"017","Brescia",45,2650,7655,497,33,10835,1701,7666,648,179,10194
"017","Brescia",46,2447,7610,451,40,10548,1652,7695,631,181,10159
"017","Brescia",47,2235,7971,496,50,10752,1619,7728,654,204,10205
"017","Brescia",48,1998,7294,532,60,9884,1393,7384,641,252,9670
"017","Brescia",49,1774,7256,508,58,9596,1288,7129,568,241,9226
"017","Brescia",50,1589,7145,497,63,9294,1308,6985,567,272,9132
"017","Brescia",51,1475,6923,456,59,8913,1189,6706,533,301,8729
"017","Brescia",52,1343,6585,424,63,8415,1137,6464,531,318,8450
"017","Brescia",53,1262,6462,386,88,8198,1041,6187,503,354,8085
"017","Brescia",54,1128,6306,394,79,7907,963,6207,489,373,8032
"017","Brescia",55,1139,6367,357,102,7965,917,6031,448,466,7862
"017","Brescia",56,992,6041,378,99,7510,832,5849,421,464,7566
"017","Brescia",57,946,5983,331,108,7368,776,5756,377,474,7383
"017","Brescia",58,832,5884,298,126,7140,710,5612,357,538,7217
"017","Brescia",59,858,5735,299,124,7016,735,5653,286,603,7277
"017","Brescia",60,805,5685,268,155,6913,669,5626,293,697,7285
"017","Brescia",61,751,6102,288,170,7311,677,5736,289,765,7467
"017","Brescia",62,813,6004,248,233,7298,621,5792,279,887,7579
"017","Brescia",63,794,6415,234,216,7659,638,5910,261,1011,7820
"017","Brescia",64,683,6085,239,246,7253,602,5565,250,1118,7535
"017","Brescia",65,735,6189,206,261,7391,550,5601,265,1267,7683
"017","Brescia",66,500,4377,153,219,5249,401,3998,184,1095,5678
"017","Brescia",67,572,4930,126,260,5888,482,4334,167,1303,6286
"017","Brescia",68,510,4807,112,302,5731,420,4315,144,1474,6353
"017","Brescia",69,629,4867,105,324,5925,466,4182,152,1564,6364
"017","Brescia",70,629,4821,121,362,5933,476,4099,152,1819,6546
"017","Brescia",71,586,5013,110,441,6150,537,4137,145,2175,6994
"017","Brescia",72,537,4896,97,417,5947,544,3964,121,2300,6929
"017","Brescia",73,533,4606,78,470,5687,519,3657,88,2397,6661
"017","Brescia",74,443,3933,70,431,4877,504,3032,96,2346,5978
"017","Brescia",75,364,3310,39,392,4105,480,2544,68,2357,5449
"017","Brescia",76,387,3380,52,457,4276,433,2540,69,2589,5631
"017","Brescia",77,364,2956,44,466,3830,470,2082,56,2618,5226
"017","Brescia",78,340,2722,29,450,3541,464,1924,59,2688,5135
"017","Brescia",79,326,2649,29,448,3452,479,1666,60,2873,5078
"017","Brescia",80,280,2252,29,465,3026,474,1483,45,2962,4964
"017","Brescia",81,254,2149,20,467,2890,509,1343,62,3082,4996
"017","Brescia",82,181,1881,14,494,2570,512,1050,35,3005,4602
"017","Brescia",83,178,1540,14,460,2192,501,894,25,2975,4395
"017","Brescia",84,159,1328,10,451,1948,449,718,36,2923,4126
"017","Brescia",85,141,1085,11,441,1678,426,555,23,2708,3712
"017","Brescia",86,94,907,6,399,1406,372,464,33,2447,3316
"017","Brescia",87,74,705,5,377,1161,380,359,18,2328,3085
"017","Brescia",88,65,605,4,376,1050,319,231,16,2195,2761
"017","Brescia",89,42,453,5,266,766,275,195,7,1933,2410
"017","Brescia",90,33,348,1,249,631,216,130,13,1585,1944
"017","Brescia",91,28,241,2,177,448,201,66,6,1326,1599
"017","Brescia",92,12,119,2,126,259,91,46,5,766,908
"017","Brescia",93,7,75,1,83,166,76,15,1,495,587
"017","Brescia",94,8,48,2,57,115,74,12,1,436,523
"017","Brescia",95,7,31,0,51,89,66,15,4,396,481
"017","Brescia",96,4,25,0,41,70,60,7,1,369,437
"017","Brescia",97,5,25,1,25,56,45,3,0,324,372
"017","Brescia",98,2,7,0,29,38,46,3,1,200,250
"017","Brescia",99,0,4,0,19,23,23,3,1,131,158
"017","Brescia",100,3,5,0,25,33,35,3,0,196,234
"018","Pavia",0,2298,0,0,0,2298,2213,0,0,0,2213
"018","Pavia",1,2321,0,0,0,2321,2178,0,0,0,2178
"018","Pavia",2,2497,0,0,0,2497,2284,0,0,0,2284
"018","Pavia",3,2433,0,0,0,2433,2421,0,0,0,2421
"018","Pavia",4,2375,0,0,0,2375,2297,0,0,0,2297
"018","Pavia",5,2339,0,0,0,2339,2259,0,0,0,2259
"018","Pavia",6,2416,0,0,0,2416,2231,0,0,0,2231
"018","Pavia",7,2346,0,0,0,2346,2193,0,0,0,2193
"018","Pavia",8,2387,0,0,0,2387,2066,0,0,0,2066
"018","Pavia",9,2251,0,0,0,2251,2142,0,0,0,2142
"018","Pavia",10,2269,0,0,0,2269,2189,0,0,0,2189
"018","Pavia",11,2290,0,0,0,2290,2142,0,0,0,2142
"018","Pavia",12,2227,0,0,0,2227,2132,0,0,0,2132
"018","Pavia",13,2218,0,0,0,2218,2171,0,0,0,2171
"018","Pavia",14,2211,0,0,0,2211,2135,0,0,0,2135
"018","Pavia",15,2203,0,0,0,2203,2001,0,0,0,2001
"018","Pavia",16,2137,0,0,0,2137,2044,0,0,0,2044
"018","Pavia",17,2154,0,0,0,2154,2033,0,0,0,2033
"018","Pavia",18,2234,0,0,0,2234,2079,5,0,0,2084
"018","Pavia",19,2223,3,0,0,2226,2140,34,1,0,2175
"018","Pavia",20,2303,2,0,0,2305,2098,77,0,0,2175
"018","Pavia",21,2396,11,0,0,2407,2151,111,1,0,2263
"018","Pavia",22,2354,22,0,0,2376,2110,183,2,0,2295
"018","Pavia",23,2350,54,0,0,2404,2097,317,0,0,2414
"018","Pavia",24,2366,111,0,0,2477,2030,418,5,0,2453
"018","Pavia",25,2336,169,0,0,2505,1912,464,5,0,2381
"018","Pavia",26,2319,225,1,0,2545,1994,658,8,0,2660
"018","Pavia",27,2301,327,2,0,2630,1949,797,10,1,2757
"018","Pavia",28,2280,465,4,0,2749,1916,963,11,1,2891
"018","Pavia",29,2431,631,6,0,3068,1698,1224,11,3,2936
"018","Pavia",30,2256,729,6,0,2991,1694,1354,18,6,3072
"018","Pavia",31,2258,885,10,0,3153,1523,1566,24,8,3121
"018","Pavia",32,2221,1153,11,1,3386,1597,1735,35,5,3372
"018","Pavia",33,2184,1350,17,1,3552,1514,1952,60,14,3540
"018","Pavia",34,2205,1592,23,0,3820,1517,2096,71,8,3692
"018","Pavia",35,2172,1855,31,4,4062,1371,2426,81,18,3896
"018","Pavia",36,2165,1938,42,2,4147,1463,2513,101,11,4088
"018","Pavia",37,2081,2292,63,5,4441,1406,2766,154,17,4343
"018","Pavia",38,1866,2396,83,8,4353,1264,2932,150,23,4369
"018","Pavia",39,1857,2502,107,4,4470,1146,2922,184,35,4287
"018","Pavia",40,1705,2646,121,10,4482,1047,2944,209,27,4227
"018","Pavia",41,1615,2737,140,11,4503,969,2932,205,35,4141
"018","Pavia",42,1480,2939,157,10,4586,985,3258,239,38,4520
"018","Pavia",43,1462,2920,183,14,4579,843,3209,223,59,4334
"018","Pavia",44,1366,3160,207,8,4741,890,3234,273,64,4461
"018","Pavia",45,1293,3193,214,18,4718,834,3366,287,81,4568
"018","Pavia",46,1179,3181,246,17,4623,737,3261,300,69,4367
"018","Pavia",47,1057,3249,270,23,4599,708,3410,288,93,4499
"018","Pavia",48,992,3141,249,23,4405,631,3289,279,103,4302
"018","Pavia",49,908,3107,218,17,4250,562,3204,271,114,4151
"018","Pavia",50,784,2997,222,29,4032,565,3054,281,130,4030
"018","Pavia",51,711,2906,206,33,3856,541,2989,261,145,3936
"018","Pavia",52,672,2972,225,32,3901,452,2956,268,147,3823
"018","Pavia",53,597,2766,199,34,3596,427,2863,267,161,3718
"018","Pavia",54,527,2852,229,37,3645,455,2844,226,207,3732
"018","Pavia",55,530,2831,201,39,3601,387,2801,241,232,3661
"018","Pavia",56,509,2737,192,50,3488,387,2747,222,231,3587
"018","Pavia",57,436,2651,170,51,3308,324,2673,208,267,3472
"018","Pavia",58,446,2659,191,67,3363,295,2543,213,282,3333
"018","Pavia",59,428,2593,150,76,3247,293,2497,189,332,3311
"018","Pavia",60,369,2681,153,76,3279,265,2587,154,375,3381
"018","Pavia",61,403,2794,153,101,3451,270,2692,198,405,3565
"018","Pavia",62,370,2726,136,109,3341,245,2593,162,498,3498
"018","Pavia",63,383,2801,143,120,3447,260,2723,157,562,3702
"018","Pavia",64,349,2867,129,106,3451,250,2633,162,557,3602
"018","Pavia",65,341,2707,118,139,3305,247,2547,143,640,3577
"018","Pavia",66,235,1982,78,122,2417,162,1786,101,550,2599
"018","Pavia",67,242,2137,86,108,2573,158,1976,99,676,2909
"018","Pavia",68,256,2179,77,152,2664,201,1935,112,713,2961
"018","Pavia",69,300,2147,74,167,2688,192,1911,89,778,2970
"018","Pavia",70,275,2116,76,177,2644,181,1976,87,913,3157
"018","Pavia",71,307,2465,74,213,3059,222,2035,82,1136,3475
"018","Pavia",72,315,2337,69,263,2984,198,1941,76,1208,3423
"018","Pavia",73,282,2189,69,243,2783,225,1825,75,1288,3413
"018","Pavia",74,257,1987,39,242,2525,181,1517,54,1355,3107
"018","Pavia",75,247,1753,43,252,2295,198,1408,63,1347,3016
"018","Pavia",76,236,1806,30,268,2340,199,1339,63,1524,3125
"018","Pavia",77,217,1655,32,294,2198,185,1245,47,1588,3065
"018","Pavia",78,180,1515,22,283,2000,231,1068,48,1702,3049
"018","Pavia",79,187,1414,21,267,1889,214,926,41,1712,2893
"018","Pavia",80,174,1294,17,316,1801,218,850,39,1763,2870
"018","Pavia",81,163,1157,16,285,1621,223,759,35,1765,2782
"018","Pavia",82,127,1001,15,271,1414,214,558,28,1755,2555
"018","Pavia",83,132,843,16,286,1277,206,495,23,1699,2423
"018","Pavia",84,114,751,6,294,1165,190,418,12,1649,2269
"018","Pavia",85,76,600,7,230,913,192,305,16,1575,2088
"018","Pavia",86,57,488,9,271,825,165,266,21,1511,1963
"018","Pavia",87,61,407,7,232,707,180,192,18,1335,1725
"018","Pavia",88,51,379,4,215,649,136,133,14,1216,1499
"018","Pavia",89,34,278,5,186,503,150,100,17,1139,1406
"018","Pavia",90,27,216,2,133,378,103,69,4,1013,1189
"018","Pavia",91,21,148,1,121,291,90,28,2,799,919
"018","Pavia",92,10,67,0,59,136,39,24,0,422,485
"018","Pavia",93,4,44,1,32,81,41,5,4,276,326
"018","Pavia",94,6,29,0,35,70,18,5,1,250,274
"018","Pavia",95,8,26,0,34,68,32,5,2,250,289
"018","Pavia",96,9,16,0,28,53,22,5,1,266,294
"018","Pavia",97,1,15,0,30,46,16,4,1,203,224
"018","Pavia",98,1,6,0,25,32,16,2,0,135,153
"018","Pavia",99,1,1,0,13,15,8,2,0,110,120
"018","Pavia",100,0,6,0,16,22,17,2,0,143,162
"019","Cremona",0,1612,0,0,0,1612,1442,0,0,0,1442
"019","Cremona",1,1696,0,0,0,1696,1568,0,0,0,1568
"019","Cremona",2,1742,0,0,0,1742,1571,0,0,0,1571
"019","Cremona",3,1793,0,0,0,1793,1645,0,0,0,1645
"019","Cremona",4,1689,0,0,0,1689,1598,0,0,0,1598
"019","Cremona",5,1678,0,0,0,1678,1564,0,0,0,1564
"019","Cremona",6,1655,0,0,0,1655,1556,0,0,0,1556
"019","Cremona",7,1662,0,0,0,1662,1495,0,0,0,1495
"019","Cremona",8,1643,0,0,0,1643,1459,0,0,0,1459
"019","Cremona",9,1598,0,0,0,1598,1490,0,0,0,1490
"019","Cremona",10,1557,0,0,0,1557,1612,0,0,0,1612
"019","Cremona",11,1661,0,0,0,1661,1585,0,0,0,1585
"019","Cremona",12,1620,0,0,0,1620,1520,0,0,0,1520
"019","Cremona",13,1587,0,0,0,1587,1597,0,0,0,1597
"019","Cremona",14,1601,0,0,0,1601,1485,0,0,0,1485
"019","Cremona",15,1536,0,0,0,1536,1519,0,0,0,1519
"019","Cremona",16,1598,0,0,0,1598,1490,0,0,0,1490
"019","Cremona",17,1622,0,0,0,1622,1475,2,0,0,1477
"019","Cremona",18,1598,1,0,0,1599,1520,2,0,0,1522
"019","Cremona",19,1610,2,0,0,1612,1523,27,0,0,1550
"019","Cremona",20,1655,5,0,0,1660,1502,63,0,0,1565
"019","Cremona",21,1679,12,0,0,1691,1525,99,0,1,1625
"019","Cremona",22,1733,19,0,0,1752,1505,141,0,1,1647
"019","Cremona",23,1739,41,0,0,1780,1380,220,0,0,1600
"019","Cremona",24,1692,66,0,0,1758,1391,282,2,0,1675
"019","Cremona",25,1590,111,0,0,1701,1346,426,4,0,1776
"019","Cremona",26,1732,167,2,0,1901,1322,489,2,4,1817
"019","Cremona",27,1679,257,0,1,1937,1239,667,4,4,1914
"019","Cremona",28,1595,349,0,0,1944,1108,779,10,3,1900
"019","Cremona",29,1630,477,3,0,2110,1086,936,10,3,2035
"019","Cremona",30,1514,618,4,0,2136,1000,1000,20,2,2022
"019","Cremona",31,1429,707,8,0,2144,920,1206,20,3,2149
"019","Cremona",32,1384,893,7,0,2284,919,1215,19,5,2158
"019","Cremona",33,1423,964,10,2,2399,854,1439,30,7,2330
"019","Cremona",34,1415,1144,8,3,2570,813,1569,44,9,2435
"019","Cremona",35,1343,1300,22,2,2667,848,1662,55,7,2572
"019","Cremona",36,1336,1474,31,1,2842,764,1807,59,15,2645
"019","Cremona",37,1292,1597,42,1,2932,740,1820,95,10,2665
"019","Cremona",38,1107,1608,48,2,2765,677,1923,112,17,2729
"019","Cremona",39,1132,1723,69,1,2925,660,1870,92,16,2638
"019","Cremona",40,1074,1805,78,5,2962,601,1967,107,29,2704
"019","Cremona",41,934,1787,85,6,2812,493,2075,139,30,2737
"019","Cremona",42,928,2042,104,6,3080,555,2124,125,38,2842
"019","Cremona",43,871,2083,127,10,3091,528,2096,170,40,2834
"019","Cremona",44,807,2051,115,9,2982,479,2116,151,46,2792
"019","Cremona",45,813,2195,126,5,3139,463,2225,152,40,2880
"019","Cremona",46,732,2176,127,13,3048,472,2214,166,46,2898
"019","Cremona",47,667,2165,133,9,2974,390,2298,127,63,2878
"019","Cremona",48,610,2151,124,19,2904,390,2224,147,75,2836
"019","Cremona",49,540,2061,114,13,2728,328,2112,164,74,2678
"019","Cremona",50,489,2015,123,19,2646,306,2044,146,101,2597
"019","Cremona",51,463,2027,108,21,2619,283,2061,147,99,2590
"019","Cremona",52,439,2025,116,23,2603,266,1971,137,106,2480
"019","Cremona",53,406,1925,117,33,2481,287,1969,131,106,2493
"019","Cremona",54,390,1827,123,31,2371,245,1930,132,105,2412
"019","Cremona",55,350,1863,89,40,2342,197,1912,104,146,2359
"019","Cremona",56,363,1816,86,33,2298,222,1949,113,169,2453
"019","Cremona",57,304,1835,83,34,2256,180,1806,100,178,2264
"019","Cremona",58,321,1748,69,31,2169,172,1793,108,187,2260
"019","Cremona",59,294,1781,103,43,2221,185,1730,88,216,2219
"019","Cremona",60,308,1819,86,44,2257,172,1731,89,216,2208
"019","Cremona",61,339,1909,96,62,2406,163,1805,87,246,2301
"019","Cremona",62,304,1926,82,64,2376,164,1846,88,300,2398
"019","Cremona",63,311,1952,64,64,2391,170,1916,70,337,2493
"019","Cremona",64,260,1958,76,74,2368,148,1751,62,385,2346
"019","Cremona",65,235,1907,47,102,2291,177,1775,69,410,2431
"019","Cremona",66,179,1317,38,57,1591,140,1133,59,347,1679
"019","Cremona",67,216,1373,25,80,1694,142,1303,40,393,1878
"019","Cremona",68,214,1418,31,97,1760,149,1237,38,449,1873
"019","Cremona",69,214,1462,34,100,1810,151,1269,46,541,2007
"019","Cremona",70,219,1447,36,128,1830,152,1290,40,619,2101
"019","Cremona",71,266,1559,27,135,1987,180,1297,48,710,2235
"019","Cremona",72,243,1549,31,144,1967,155,1236,34,804,2229
"019","Cremona",73,204,1445,32,156,1837,178,1147,36,875,2236
"019","Cremona",74,198,1294,20,131,1643,150,960,31,817,1958
"019","Cremona",75,180,1108,13,128,1429,164,865,23,866,1918
"019","Cremona",76,175,1111,14,156,1456,150,868,24,943,1985
"019","Cremona",77,147,986,16,177,1326,152,702,13,977,1844
"019","Cremona",78,139,956,8,145,1248,160,609,16,996,1781
"019","Cremona",79,120,827,10,170,1127,151,568,28,1015,1762
"019","Cremona",80,120,783,8,161,1072,160,497,18,1056,1731
"019","Cremona",81,94,723,6,197,1020,152,449,11,1114,1726
"019","Cremona",82,91,568,8,176,843,169,378,11,1083,1641
"019","Cremona",83,73,528,8,186,795,176,305,12,1019,1512
"019","Cremona",84,62,499,5,160,726,158,240,13,1029,1440
"019","Cremona",85,55,409,2,167,633,128,199,9,1006,1342
"019","Cremona",86,50,292,0,149,491,143,147,5,983,1278
"019","Cremona",87,27,278,0,137,442,133,107,8,936,1184
"019","Cremona",88,33,212,3,119,367,110,75,2,795,982
"019","Cremona",89,28,155,2,114,299,108,65,5,738,916
"019","Cremona",90,15,144,4,104,267,89,47,3,626,765
"019","Cremona",91,9,96,0,88,193,80,28,2,560,670
"019","Cremona",92,5,36,1,42,84,39,12,1,265,317
"019","Cremona",93,4,20,0,18,42,25,3,1,148,177
"019","Cremona",94,2,9,0,16,27,20,5,0,122,147
"019","Cremona",95,3,10,0,11,24,16,2,1,136,155
"019","Cremona",96,6,10,0,18,34,17,3,0,150,170
"019","Cremona",97,2,8,0,8,18,16,1,0,109,126
"019","Cremona",98,0,4,0,4,8,7,0,0,65,72
"019","Cremona",99,2,2,0,4,8,7,1,1,48,57
"019","Cremona",100,1,1,0,10,12,11,0,0,67,78
"020","Mantova",0,1971,0,0,0,1971,1897,0,0,0,1897
"020","Mantova",1,2138,0,0,0,2138,1925,0,0,0,1925
"020","Mantova",2,2008,0,0,0,2008,1991,0,0,0,1991
"020","Mantova",3,2068,0,0,0,2068,1922,0,0,0,1922
"020","Mantova",4,2060,0,0,0,2060,1943,0,0,0,1943
"020","Mantova",5,2026,0,0,0,2026,1892,0,0,0,1892
"020","Mantova",6,1976,0,0,0,1976,1843,0,0,0,1843
"020","Mantova",7,1886,0,0,0,1886,1904,0,0,0,1904
"020","Mantova",8,1848,0,0,0,1848,1692,0,0,0,1692
"020","Mantova",9,1865,0,0,0,1865,1737,0,0,0,1737
"020","Mantova",10,1894,0,0,0,1894,1728,0,0,0,1728
"020","Mantova",11,1924,0,0,0,1924,1760,0,0,0,1760
"020","Mantova",12,1928,0,0,0,1928,1764,0,0,0,1764
"020","Mantova",13,1876,0,0,0,1876,1727,0,0,0,1727
"020","Mantova",14,1811,0,0,0,1811,1650,0,0,0,1650
"020","Mantova",15,1810,0,0,0,1810,1648,0,0,0,1648
"020","Mantova",16,1704,0,0,0,1704,1579,0,0,0,1579
"020","Mantova",17,1834,0,0,0,1834,1633,3,0,0,1636
"020","Mantova",18,1795,0,0,0,1795,1644,5,0,0,1649
"020","Mantova",19,1851,4,0,0,1855,1655,26,0,0,1681
"020","Mantova",20,1770,7,0,0,1777,1593,74,0,0,1667
"020","Mantova",21,1807,19,0,0,1826,1639,122,0,0,1761
"020","Mantova",22,1749,34,1,0,1784,1574,185,1,1,1761
"020","Mantova",23,1893,46,0,0,1939,1592,312,1,1,1906
"020","Mantova",24,1818,101,0,0,1919,1453,401,2,0,1856
"020","Mantova",25,1910,152,0,0,2062,1416,534,3,0,1953
"020","Mantova",26,1852,212,2,0,2066,1483,631,6,1,2121
"020","Mantova",27,1850,313,2,0,2165,1310,789,4,2,2105
"020","Mantova",28,1822,450,2,0,2274,1238,916,10,1,2165
"020","Mantova",29,1752,555,6,0,2313,1189,1061,11,1,2262
"020","Mantova",30,1755,689,8,2,2454,1192,1269,16,4,2481
"020","Mantova",31,1747,813,6,0,2566,1229,1385,18,5,2637
"020","Mantova",32,1669,967,10,0,2646,1021,1496,39,3,2559
"020","Mantova",33,1705,1305,17,1,3028,1067,1657,46,5,2775
"020","Mantova",34,1656,1414,26,0,3096,1116,1794,57,13,2980
"020","Mantova",35,1632,1521,33,3,3189,1057,1867,78,12,3014
"020","Mantova",36,1600,1649,63,2,3314,1021,2066,81,12,3180
"020","Mantova",37,1560,1848,58,3,3469,1005,2143,113,15,3276
"020","Mantova",38,1477,1957,55,3,3492,947,2225,146,16,3334
"020","Mantova",39,1393,2085,87,6,3571,843,2268,136,24,3271
"020","Mantova",40,1196,2092,93,4,3385,822,2329,160,25,3336
"020","Mantova",41,1176,2209,121,1,3507,714,2292,157,32,3195
"020","Mantova",42,1082,2345,115,7,3549,670,2362,176,38,3246
"020","Mantova",43,1005,2379,110,7,3501,675,2416,207,39,3337
"020","Mantova",44,936,2340,159,4,3439,587,2419,195,36,3237
"020","Mantova",45,809,2406,174,16,3405,557,2406,187,43,3193
"020","Mantova",46,823,2516,148,14,3501,497,2459,214,60,3230
"020","Mantova",47,698,2551,170,21,3440,465,2494,251,67,3277
"020","Mantova",48,626,2350,167,26,3169,483,2349,169,72,3073
"020","Mantova",49,554,2303,172,24,3053,422,2346,206,88,3062
"020","Mantova",50,519,2393,179,18,3109,365,2378,200,80,3023
"020","Mantova",51,495,2249,146,18,2908,364,2203,200,100,2867
"020","Mantova",52,427,2147,163,26,2763,343,2191,199,116,2849
"020","Mantova",53,375,2053,134,29,2591,301,2079,171,112,2663
"020","Mantova",54,387,2137,143,29,2696,287,2113,158,136,2694
"020","Mantova",55,343,2123,137,32,2635,257,2059,167,167,2650
"020","Mantova",56,303,2032,115,38,2488,279,2106,157,134,2676
"020","Mantova",57,307,2062,116,38,2523,258,2046,150,168,2622
"020","Mantova",58,239,1933,102,39,2313,210,1944,125,186,2465
"020","Mantova",59,261,1914,106,59,2340,200,1973,142,222,2537
"020","Mantova",60,219,1928,97,59,2303,173,1941,126,189,2429
"020","Mantova",61,236,2016,81,47,2380,195,1998,105,273,2571
"020","Mantova",62,224,2137,79,63,2503,186,2005,109,306,2606
"020","Mantova",63,231,2188,79,81,2579,191,2097,115,340,2743
"020","Mantova",64,234,2232,94,90,2650,188,2131,88,413,2820
"020","Mantova",65,277,2261,73,115,2726,163,2085,100,415,2763
"020","Mantova",66,139,1415,47,73,1674,116,1350,70,362,1898
"020","Mantova",67,186,1625,58,97,1966,143,1523,56,457,2179
"020","Mantova",68,187,1551,41,85,1864,143,1533,66,494,2236
"020","Mantova",69,192,1580,58,87,1917,151,1451,51,522,2175
"020","Mantova",70,205,1550,38,105,1898,119,1464,57,632,2272
"020","Mantova",71,201,1765,40,140,2146,166,1556,40,682,2444
"020","Mantova",72,189,1612,30,152,1983,141,1466,41,792,2440
"020","Mantova",73,163,1660,29,144,1996,122,1467,33,859,2481
"020","Mantova",74,177,1478,18,117,1790,148,1167,34,869,2218
"020","Mantova",75,143,1307,23,166,1639,125,1033,22,825,2005
"020","Mantova",76,137,1366,20,199,1722,137,1045,26,1026,2234
"020","Mantova",77,129,1303,9,182,1623,160,891,22,1049,2122
"020","Mantova",78,115,1125,14,156,1410,130,760,18,1080,1988
"020","Mantova",79,124,994,10,166,1294,137,665,19,1136,1957
"020","Mantova",80,101,1014,3,184,1302,134,615,11,1226,1986
"020","Mantova",81,107,857,8,176,1148,139,551,20,1197,1907
"020","Mantova",82,86,728,12,181,1007,119,412,9,1144,1684
"020","Mantova",83,88,661,6,194,949,136,364,13,1236,1749
"020","Mantova",84,61,563,3,186,813,121,317,9,1224,1671
"020","Mantova",85,55,508,4,179,746,107,241,3,1217,1568
"020","Mantova",86,47,438,4,193,682,113,189,17,1119,1438
"020","Mantova",87,32,344,3,170,549,111,160,6,1038,1315
"020","Mantova",88,34,294,2,162,492,108,98,4,1003,1213
"020","Mantova",89,24,235,3,135,397,78,66,9,908,1061
"020","Mantova",90,22,175,2,136,335,82,44,4,819,949
"020","Mantova",91,8,144,0,126,278,62,33,2,671,768
"020","Mantova",92,3,48,1,53,105,29,11,1,378,419
"020","Mantova",93,2,38,0,28,68,26,8,0,193,227
"020","Mantova",94,5,24,2,22,53,23,2,0,178,203
"020","Mantova",95,0,15,0,23,38,18,4,2,202,226
"020","Mantova",96,3,9,0,37,49,18,2,0,192,212
"020","Mantova",97,4,7,0,26,37,14,2,0,132,148
"020","Mantova",98,1,6,0,20,27,15,2,1,78,96
"020","Mantova",99,1,1,0,18,20,4,1,0,66,71
"020","Mantova",100,0,2,0,10,12,9,0,0,110,119
"021","Bolzano/Bozen",0,2642,0,0,0,2642,2510,0,0,0,2510
"021","Bolzano/Bozen",1,2765,0,0,0,2765,2568,0,0,0,2568
"021","Bolzano/Bozen",2,2719,0,0,0,2719,2545,0,0,0,2545
"021","Bolzano/Bozen",3,2811,0,0,0,2811,2634,0,0,0,2634
"021","Bolzano/Bozen",4,2917,0,0,0,2917,2617,0,0,0,2617
"021","Bolzano/Bozen",5,2808,0,0,0,2808,2696,0,0,0,2696
"021","Bolzano/Bozen",6,2901,0,0,0,2901,2726,0,0,0,2726
"021","Bolzano/Bozen",7,2863,0,0,0,2863,2710,0,0,0,2710
"021","Bolzano/Bozen",8,2864,0,0,0,2864,2646,0,0,0,2646
"021","Bolzano/Bozen",9,2743,0,0,0,2743,2629,0,0,0,2629
"021","Bolzano/Bozen",10,2907,0,0,0,2907,2719,0,0,0,2719
"021","Bolzano/Bozen",11,2900,0,0,0,2900,2777,0,0,0,2777
"021","Bolzano/Bozen",12,2913,0,0,0,2913,2820,0,0,0,2820
"021","Bolzano/Bozen",13,2880,0,0,0,2880,2814,0,0,0,2814
"021","Bolzano/Bozen",14,3011,0,0,0,3011,2784,0,0,0,2784
"021","Bolzano/Bozen",15,2893,0,0,0,2893,2810,0,0,0,2810
"021","Bolzano/Bozen",16,2870,0,0,0,2870,2590,0,0,0,2590
"021","Bolzano/Bozen",17,2870,0,0,0,2870,2727,0,0,0,2727
"021","Bolzano/Bozen",18,2748,0,0,0,2748,2709,11,0,0,2720
"021","Bolzano/Bozen",19,2909,1,0,0,2910,2726,25,0,0,2751
"021","Bolzano/Bozen",20,2905,8,0,0,2913,2750,60,0,0,2810
"021","Bolzano/Bozen",21,2867,13,0,0,2880,2663,94,0,0,2757
"021","Bolzano/Bozen",22,2868,26,1,0,2895,2611,128,1,2,2742
"021","Bolzano/Bozen",23,2790,43,0,0,2833,2554,171,0,0,2725
"021","Bolzano/Bozen",24,2690,74,0,0,2764,2434,243,3,0,2680
"021","Bolzano/Bozen",25,2738,123,0,0,2861,2378,354,6,1,2739
"021","Bolzano/Bozen",26,2740,160,1,0,2901,2337,496,2,1,2836
"021","Bolzano/Bozen",27,2782,256,1,0,3039,2188,598,10,1,2797
"021","Bolzano/Bozen",28,2711,359,0,0,3070,2289,745,10,2,3046
"021","Bolzano/Bozen",29,2734,484,3,0,3221,2251,935,9,1,3196
"021","Bolzano/Bozen",30,2625,624,2,1,3252,2122,1080,13,1,3216
"021","Bolzano/Bozen",31,2527,786,9,0,3322,1898,1260,24,1,3183
"021","Bolzano/Bozen",32,2334,800,10,0,3144,1829,1336,30,1,3196
"021","Bolzano/Bozen",33,2283,1011,20,0,3314,1762,1486,37,10,3295
"021","Bolzano/Bozen",34,2191,1102,15,0,3308,1633,1616,55,13,3317
"021","Bolzano/Bozen",35,2055,1275,23,1,3354,1618,1728,61,3,3410
"021","Bolzano/Bozen",36,2026,1532,38,2,3598,1579,1933,83,9,3604
"021","Bolzano/Bozen",37,2081,1680,52,2,3815,1592,2083,90,16,3781
"021","Bolzano/Bozen",38,1961,1760,56,3,3780,1532,2209,141,16,3898
"021","Bolzano/Bozen",39,2018,1953,64,4,4039,1526,2367,155,17,4065
"021","Bolzano/Bozen",40,1984,2151,106,4,4245,1396,2515,189,18,4118
"021","Bolzano/Bozen",41,1807,2246,121,5,4179,1249,2633,220,25,4127
"021","Bolzano/Bozen",42,1931,2430,150,10,4521,1193,2772,198,37,4200
"021","Bolzano/Bozen",43,1655,2540,157,8,4360,1175,2794,234,46,4249
"021","Bolzano/Bozen",44,1506,2553,174,9,4242,1089,2825,227,57,4198
"021","Bolzano/Bozen",45,1561,2737,186,7,4491,1010,2891,253,56,4210
"021","Bolzano/Bozen",46,1371,2941,175,16,4503,1016,2852,270,68,4206
"021","Bolzano/Bozen",47,1278,2982,197,20,4477,872,2936,263,80,4151
"021","Bolzano/Bozen",48,1116,2801,220,19,4156,826,2829,242,71,3968
"021","Bolzano/Bozen",49,972,2722,199,19,3912,755,2771,255,80,3861
"021","Bolzano/Bozen",50,910,2669,218,23,3820,725,2735,244,91,3795
"021","Bolzano/Bozen",51,848,2664,215,22,3749,656,2566,235,109,3566
"021","Bolzano/Bozen",52,727,2687,220,24,3658,615,2422,229,113,3379
"021","Bolzano/Bozen",53,722,2466,183,24,3395,585,2323,204,123,3235
"021","Bolzano/Bozen",54,607,2306,161,34,3108,552,2372,210,140,3274
"021","Bolzano/Bozen",55,575,2276,161,29,3041,487,2222,195,149,3053
"021","Bolzano/Bozen",56,504,2202,151,30,2887,443,2107,174,168,2892
"021","Bolzano/Bozen",57,475,2092,160,32,2759,422,2012,176,178,2788
"021","Bolzano/Bozen",58,429,2066,132,29,2656,393,2062,162,188,2805
"021","Bolzano/Bozen",59,414,1992,139,38,2583,371,2016,150,221,2758
"021","Bolzano/Bozen",60,362,2013,131,59,2565,306,1928,152,241,2627
"021","Bolzano/Bozen",61,387,2016,148,50,2601,355,1911,173,286,2725
"021","Bolzano/Bozen",62,349,1946,132,68,2495,317,1900,137,295,2649
"021","Bolzano/Bozen",63,322,2090,126,61,2599,318,2018,110,317,2763
"021","Bolzano/Bozen",64,299,1954,103,83,2439,274,1974,142,353,2743
"021","Bolzano/Bozen",65,318,2178,98,92,2686,347,2048,144,446,2985
"021","Bolzano/Bozen",66,232,1652,69,66,2019,244,1463,106,360,2173
"021","Bolzano/Bozen",67,276,1867,82,96,2321,260,1748,95,483,2586
"021","Bolzano/Bozen",68,290,2098,73,125,2586,284,1783,113,555,2735
"021","Bolzano/Bozen",69,274,2021,109,91,2495,290,1788,93,629,2800
"021","Bolzano/Bozen",70,292,2027,72,146,2537,261,1813,87,664,2825
"021","Bolzano/Bozen",71,251,1797,52,135,2235,263,1512,81,693,2549
"021","Bolzano/Bozen",72,242,1753,45,131,2171,235,1471,82,787,2575
"021","Bolzano/Bozen",73,187,1665,47,168,2067,250,1285,61,752,2348
"021","Bolzano/Bozen",74,182,1456,50,125,1813,237,1120,49,735,2141
"021","Bolzano/Bozen",75,177,1319,25,121,1642,254,1000,46,774,2074
"021","Bolzano/Bozen",76,177,1206,32,150,1565,228,922,37,856,2043
"021","Bolzano/Bozen",77,158,1225,25,171,1579,240,816,33,888,1977
"021","Bolzano/Bozen",78,166,1128,22,169,1485,252,750,26,929,1957
"021","Bolzano/Bozen",79,136,1084,16,176,1412,245,687,28,967,1927
"021","Bolzano/Bozen",80,131,974,17,190,1312,207,622,22,992,1843
"021","Bolzano/Bozen",81,103,947,11,193,1254,257,542,33,987,1819
"021","Bolzano/Bozen",82,90,767,8,162,1027,209,445,17,977,1648
"021","Bolzano/Bozen",83,97,703,12,180,992,190,360,25,957,1532
"021","Bolzano/Bozen",84,74,619,5,142,840,200,268,13,982,1463
"021","Bolzano/Bozen",85,64,544,9,174,791,196,227,12,934,1369
"021","Bolzano/Bozen",86,53,440,8,153,654,174,208,14,936,1332
"021","Bolzano/Bozen",87,50,321,2,135,508,189,164,10,809,1172
"021","Bolzano/Bozen",88,44,294,4,112,454,158,106,6,838,1108
"021","Bolzano/Bozen",89,31,232,2,120,385,130,85,11,756,982
"021","Bolzano/Bozen",90,18,152,3,94,267,126,69,13,626,834
"021","Bolzano/Bozen",91,11,124,1,81,217,86,44,4,508,642
"021","Bolzano/Bozen",92,12,57,2,55,126,48,29,4,312,393
"021","Bolzano/Bozen",93,6,23,1,27,57,30,10,3,156,199
"021","Bolzano/Bozen",94,4,28,0,26,58,22,7,4,125,158
"021","Bolzano/Bozen",95,4,11,0,21,36,23,3,0,112,138
"021","Bolzano/Bozen",96,2,17,0,16,35,33,6,1,118,158
"021","Bolzano/Bozen",97,3,10,0,22,35,14,3,2,116,135
"021","Bolzano/Bozen",98,8,7,0,12,27,7,2,0,77,86
"021","Bolzano/Bozen",99,0,6,0,17,23,10,0,0,65,75
"021","Bolzano/Bozen",100,0,4,2,11,17,22,1,2,69,94
"022","Trento",0,2603,0,0,0,2603,2574,0,0,0,2574
"022","Trento",1,2793,0,0,0,2793,2629,0,0,0,2629
"022","Trento",2,2736,0,0,0,2736,2612,0,0,0,2612
"022","Trento",3,2775,0,0,0,2775,2665,0,0,0,2665
"022","Trento",4,2684,0,0,0,2684,2599,0,0,0,2599
"022","Trento",5,2816,0,0,0,2816,2569,0,0,0,2569
"022","Trento",6,2814,0,0,0,2814,2538,0,0,0,2538
"022","Trento",7,2837,0,0,0,2837,2702,0,0,0,2702
"022","Trento",8,2742,0,0,0,2742,2556,0,0,0,2556
"022","Trento",9,2763,0,0,0,2763,2598,0,0,0,2598
"022","Trento",10,2824,0,0,0,2824,2553,0,0,0,2553
"022","Trento",11,2851,0,0,0,2851,2720,0,0,0,2720
"022","Trento",12,2751,0,0,0,2751,2661,0,0,0,2661
"022","Trento",13,2756,0,0,0,2756,2662,0,0,0,2662
"022","Trento",14,2750,0,0,0,2750,2576,0,0,0,2576
"022","Trento",15,2742,0,0,0,2742,2606,0,0,0,2606
"022","Trento",16,2659,1,0,0,2660,2554,0,0,0,2554
"022","Trento",17,2686,0,0,0,2686,2524,2,0,0,2526
"022","Trento",18,2688,0,0,0,2688,2532,6,0,0,2538
"022","Trento",19,2787,1,0,0,2788,2551,43,0,0,2594
"022","Trento",20,2708,12,0,0,2720,2425,106,0,0,2531
"022","Trento",21,2718,20,0,0,2738,2439,156,0,0,2595
"022","Trento",22,2538,35,0,0,2573,2357,216,0,0,2573
"022","Trento",23,2640,67,2,0,2709,2282,320,2,0,2604
"022","Trento",24,2565,103,1,0,2669,2276,445,2,0,2723
"022","Trento",25,2517,187,1,0,2705,2099,579,6,1,2685
"022","Trento",26,2557,244,1,0,2802,2048,699,11,1,2759
"022","Trento",27,2447,367,3,0,2817,1897,936,7,0,2840
"022","Trento",28,2482,549,5,0,3036,1843,1095,10,1,2949
"022","Trento",29,2321,701,6,0,3028,1674,1301,22,3,3000
"022","Trento",30,2202,808,6,2,3018,1505,1352,19,3,2879
"022","Trento",31,2018,1023,5,1,3047,1365,1637,30,4,3036
"022","Trento",32,1984,1228,14,0,3226,1263,1851,47,0,3161
"022","Trento",33,1955,1440,17,1,3413,1276,2081,63,9,3429
"022","Trento",34,1861,1628,21,1,3511,1214,2170,71,9,3464
"022","Trento",35,1798,1800,31,1,3630,1164,2389,107,6,3666
"022","Trento",36,1766,1921,47,3,3737,1134,2624,122,13,3893
"022","Trento",37,1738,2292,69,0,4099,1116,2773,124,14,4027
"022","Trento",38,1566,2392,85,4,4047,985,2891,162,20,4058
"022","Trento",39,1477,2462,85,5,4029,922,2869,165,18,3974
"022","Trento",40,1419,2630,103,3,4155,871,3098,181,36,4186
"022","Trento",41,1190,2721,122,4,4037,866,2943,201,33,4043
"022","Trento",42,1259,2995,121,8,4383,904,3055,211,30,4200
"022","Trento",43,1247,2951,143,7,4348,747,3170,228,34,4179
"022","Trento",44,1136,3000,196,11,4343,776,3268,250,41,4335
"022","Trento",45,1169,3043,175,10,4397,712,3377,260,64,4413
"022","Trento",46,1085,3218,238,7,4548,685,3360,267,56,4368
"022","Trento",47,944,3286,208,26,4464,619,3416,324,83,4442
"022","Trento",48,863,3125,234,18,4240,567,3225,260,95,4147
"022","Trento",49,726,2944,220,27,3917,536,3065,271,101,3973
"022","Trento",50,716,3070,198,22,4006,528,3136,269,116,4049
"022","Trento",51,705,2912,224,26,3867,494,2986,279,104,3863
"022","Trento",52,606,2951,198,21,3776,430,2985,233,120,3768
"022","Trento",53,579,2743,170,37,3529,433,2778,224,158,3593
"022","Trento",54,547,2751,200,37,3535,390,2779,246,153,3568
"022","Trento",55,526,2759,196,39,3520,353,2680,225,202,3460
"022","Trento",56,498,2652,182,43,3375,364,2658,201,173,3396
"022","Trento",57,471,2605,163,46,3285,315,2562,184,235,3296
"022","Trento",58,451,2578,178,39,3246,339,2485,185,243,3252
"022","Trento",59,400,2585,168,69,3222,291,2462,167,274,3194
"022","Trento",60,421,2539,142,54,3156,274,2390,160,299,3123
"022","Trento",61,385,2653,124,52,3214,265,2551,153,350,3319
"022","Trento",62,382,2545,136,71,3134,258,2289,141,339,3027
"022","Trento",63,386,2615,129,84,3214,230,2354,132,400,3116
"022","Trento",64,383,2505,129,86,3103,263,2343,131,435,3172
"022","Trento",65,346,2673,109,104,3232,279,2482,120,514,3395
"022","Trento",66,218,1860,82,89,2249,164,1675,96,419,2354
"022","Trento",67,249,2120,75,87,2531,236,1858,85,520,2699
"022","Trento",68,308,2064,56,112,2540,233,1933,69,607,2842
"022","Trento",69,271,2040,80,152,2543,225,1798,74,649,2746
"022","Trento",70,278,1997,61,123,2459,234,1789,68,749,2840
"022","Trento",71,276,1997,62,140,2475,234,1719,63,874,2890
"022","Trento",72,270,1872,46,172,2360,241,1507,54,870,2672
"022","Trento",73,238,1766,48,170,2222,274,1400,45,899,2618
"022","Trento",74,199,1562,34,158,1953,239,1212,36,939,2426
"022","Trento",75,204,1433,32,146,1815,215,1052,45,1016,2328
"022","Trento",76,216,1379,21,162,1778,254,985,36,1092,2367
"022","Trento",77,177,1261,22,180,1640,235,927,39,1100,2301
"022","Trento",78,172,1205,16,197,1590,242,753,19,1129,2143
"022","Trento",79,159,1088,27,173,1447,256,690,24,1130,2100
"022","Trento",80,138,1055,25,176,1394,242,626,22,1222,2112
"022","Trento",81,165,973,19,211,1368,278,592,26,1353,2249
"022","Trento",82,131,844,17,175,1167,255,479,19,1251,2004
"022","Trento",83,120,730,7,206,1063,248,407,18,1262,1935
"022","Trento",84,114,696,5,164,979,281,306,10,1254,1851
"022","Trento",85,80,548,4,172,804,272,263,8,1197,1740
"022","Trento",86,89,483,5,192,769,236,208,15,1177,1636
"022","Trento",87,62,419,6,157,644,234,146,14,1153,1547
"022","Trento",88,64,360,8,162,594,227,142,7,1118,1494
"022","Trento",89,47,278,2,148,475,181,113,12,1014,1320
"022","Trento",90,32,213,1,136,382,158,75,5,929,1167
"022","Trento",91,26,174,0,104,304,136,33,1,762,932
"022","Trento",92,7,75,2,59,143,73,28,5,441,547
"022","Trento",93,5,28,1,22,56,39,7,0,192,238
"022","Trento",94,8,21,0,11,40,29,7,3,149,188
"022","Trento",95,2,14,0,16,32,21,4,0,145,170
"022","Trento",96,6,23,1,19,49,35,3,2,169,209
"022","Trento",97,3,13,0,24,40,33,2,2,170,207
"022","Trento",98,5,9,0,14,28,30,3,0,137,170
"022","Trento",99,1,4,0,8,13,14,0,0,83,97
"022","Trento",100,2,5,0,20,27,31,0,0,120,151
"023","Verona",0,4432,0,0,0,4432,4233,0,0,0,4233
"023","Verona",1,4606,0,0,0,4606,4367,0,0,0,4367
"023","Verona",2,4640,0,0,0,4640,4345,0,0,0,4345
"023","Verona",3,4708,0,0,0,4708,4495,0,0,0,4495
"023","Verona",4,4613,0,0,0,4613,4387,0,0,0,4387
"023","Verona",5,4626,0,0,0,4626,4395,0,0,0,4395
"023","Verona",6,4618,0,0,0,4618,4372,0,0,0,4372
"023","Verona",7,4584,0,0,0,4584,4354,0,0,0,4354
"023","Verona",8,4346,0,0,0,4346,4181,0,0,0,4181
"023","Verona",9,4432,0,0,0,4432,4115,0,0,0,4115
"023","Verona",10,4361,0,0,0,4361,4193,0,0,0,4193
"023","Verona",11,4414,0,0,0,4414,4314,0,0,0,4314
"023","Verona",12,4487,0,0,0,4487,4241,0,0,0,4241
"023","Verona",13,4352,0,0,0,4352,4169,0,0,0,4169
"023","Verona",14,4272,0,0,0,4272,4159,0,0,0,4159
"023","Verona",15,4338,0,0,0,4338,3983,0,0,0,3983
"023","Verona",16,4362,0,0,0,4362,4014,0,0,0,4014
"023","Verona",17,4212,0,0,0,4212,4075,2,0,0,4077
"023","Verona",18,4200,1,0,0,4201,4048,8,0,0,4056
"023","Verona",19,4326,3,0,0,4329,3990,51,0,0,4041
"023","Verona",20,4246,8,0,0,4254,4015,105,0,0,4120
"023","Verona",21,4369,18,1,0,4388,4080,204,0,0,4284
"023","Verona",22,4409,34,0,0,4443,3935,330,0,0,4265
"023","Verona",23,4608,89,0,0,4697,3859,540,2,1,4402
"023","Verona",24,4295,203,2,0,4500,3697,779,2,0,4478
"023","Verona",25,4180,275,1,0,4456,3658,944,8,2,4612
"023","Verona",26,4564,462,2,1,5029,3531,1296,11,4,4842
"023","Verona",27,4213,610,3,0,4826,3346,1678,19,4,5047
"023","Verona",28,4145,896,8,0,5049,3127,1990,14,4,5135
"023","Verona",29,4050,1219,2,0,5271,2907,2377,22,5,5311
"023","Verona",30,4070,1611,12,0,5693,2758,2725,30,15,5528
"023","Verona",31,3774,1977,12,1,5764,2423,3086,39,14,5562
"023","Verona",32,3636,2251,20,3,5910,2434,3497,62,10,6003
"023","Verona",33,3546,2642,22,1,6211,2329,3776,91,20,6216
"023","Verona",34,3519,2963,41,1,6524,2134,4050,137,17,6338
"023","Verona",35,3304,3433,60,4,6801,2028,4471,141,23,6663
"023","Verona",36,3280,3787,74,3,7144,2040,4756,183,29,7008
"023","Verona",37,3220,4258,93,5,7576,1993,5123,226,37,7379
"023","Verona",38,2913,4356,129,2,7400,1829,5018,278,39,7164
"023","Verona",39,2833,4732,147,6,7718,1639,5223,336,35,7233
"023","Verona",40,2648,4818,185,10,7661,1606,5324,345,49,7324
"023","Verona",41,2502,4980,219,8,7709,1487,5356,363,53,7259
"023","Verona",42,2275,5341,281,11,7908,1412,5678,372,72,7534
"023","Verona",43,2090,5313,278,18,7699,1242,5609,418,66,7335
"023","Verona",44,1851,5554,331,22,7758,1323,5620,422,90,7455
"023","Verona",45,1791,5551,338,26,7706,1228,5711,491,102,7532
"023","Verona",46,1618,5721,359,30,7728,1160,5761,460,123,7504
"023","Verona",47,1529,5722,417,19,7687,1109,5826,539,169,7643
"023","Verona",48,1447,5519,352,26,7344,931,5470,481,141,7023
"023","Verona",49,1237,5267,355,32,6891,882,5176,467,173,6698
"023","Verona",50,1106,5207,363,42,6718,789,5168,442,200,6599
"023","Verona",51,1041,4916,344,41,6342,694,4929,439,219,6281
"023","Verona",52,953,4929,346,49,6277,682,4996,369,227,6274
"023","Verona",53,846,4698,336,49,5929,634,4831,367,231,6063
"023","Verona",54,800,4618,293,53,5764,596,4744,395,264,5999
"023","Verona",55,755,4650,332,58,5795,581,4572,386,332,5871
"023","Verona",56,685,4572,288,63,5608,495,4566,335,319,5715
"023","Verona",57,617,4428,267,71,5383,492,4364,318,355,5529
"023","Verona",58,595,4339,228,76,5238,404,4149,275,387,5215
"023","Verona",59,580,4189,238,97,5104,410,4141,223,441,5215
"023","Verona",60,502,4211,183,105,5001,392,4124,266,472,5254
"023","Verona",61,528,4372,182,114,5196,391,4229,261,562,5443
"023","Verona",62,476,4193,190,134,4993,382,4243,247,619,5491
"023","Verona",63,481,4532,168,158,5339,349,4442,221,710,5722
"023","Verona",64,496,4436,166,173,5271,377,4215,211,829,5632
"023","Verona",65,552,4799,190,181,5722,417,4579,226,958,6180
"023","Verona",66,325,3163,104,130,3722,276,2874,141,663,3954
"023","Verona",67,394,3566,116,179,4255,356,3375,122,863,4716
"023","Verona",68,416,3662,120,184,4382,368,3408,148,1054,4978
"023","Verona",69,412,3585,106,208,4311,341,3288,146,1033,4808
"023","Verona",70,350,3523,88,228,4189,359,3047,113,1208,4727
"023","Verona",71,394,3664,91,268,4417,362,3107,117,1371,4957
"023","Verona",72,339,3642,77,294,4352,373,3015,107,1546,5041
"023","Verona",73,394,3369,77,300,4140,338,2826,96,1665,4925
"023","Verona",74,314,3123,55,320,3812,337,2379,71,1646,4433
"023","Verona",75,314,2748,45,306,3413,312,2090,62,1699,4163
"023","Verona",76,285,2695,53,331,3364,343,1907,56,1919,4225
"023","Verona",77,265,2482,35,331,3113,325,1747,64,1968,4104
"023","Verona",78,250,2219,26,342,2837,366,1494,50,1957,3867
"023","Verona",79,215,2092,24,299,2630,357,1328,41,2204,3930
"023","Verona",80,230,1821,23,331,2405,338,1199,36,2202,3775
"023","Verona",81,179,1741,20,333,2273,396,1057,38,2336,3827
"023","Verona",82,171,1518,19,293,2001,363,819,42,2181,3405
"023","Verona",83,150,1346,11,333,1840,368,715,23,2175,3281
"023","Verona",84,127,1223,11,356,1717,358,615,23,2248,3244
"023","Verona",85,129,994,12,299,1434,335,448,24,2091,2898
"023","Verona",86,89,866,6,366,1327,311,398,15,1966,2690
"023","Verona",87,77,685,3,296,1061,304,309,16,1920,2549
"023","Verona",88,67,567,1,254,889,261,218,11,1745,2235
"023","Verona",89,43,433,5,239,720,263,162,18,1541,1984
"023","Verona",90,39,351,6,223,619,221,94,10,1393,1718
"023","Verona",91,25,233,3,178,439,158,75,11,1155,1399
"023","Verona",92,18,148,0,126,292,105,25,4,656,790
"023","Verona",93,9,75,1,59,144,77,13,3,384,477
"023","Verona",94,5,41,1,55,102,61,5,4,285,355
"023","Verona",95,7,40,0,42,89,52,7,0,293,352
"023","Verona",96,4,24,0,62,90,45,6,0,315,366
"023","Verona",97,2,29,1,44,76,50,1,0,263,314
"023","Verona",98,2,12,0,29,43,29,2,1,163,195
"023","Verona",99,4,5,0,13,22,23,3,0,122,148
"023","Verona",100,0,10,0,25,35,30,2,0,171,203
"024","Vicenza",0,4097,0,0,0,4097,3994,0,0,0,3994
"024","Vicenza",1,4361,0,0,0,4361,4148,0,0,0,4148
"024","Vicenza",2,4432,0,0,0,4432,4288,0,0,0,4288
"024","Vicenza",3,4559,0,0,0,4559,4317,0,0,0,4317
"024","Vicenza",4,4503,0,0,0,4503,4339,0,0,0,4339
"024","Vicenza",5,4565,0,0,0,4565,4281,0,0,0,4281
"024","Vicenza",6,4566,0,0,0,4566,4385,0,0,0,4385
"024","Vicenza",7,4603,0,0,0,4603,4465,0,0,0,4465
"024","Vicenza",8,4393,0,0,0,4393,4285,0,0,0,4285
"024","Vicenza",9,4419,0,0,0,4419,4359,0,0,0,4359
"024","Vicenza",10,4498,0,0,0,4498,4195,0,0,0,4195
"024","Vicenza",11,4552,0,0,0,4552,4276,0,0,0,4276
"024","Vicenza",12,4316,0,0,0,4316,4330,0,0,0,4330
"024","Vicenza",13,4496,0,0,0,4496,4171,0,0,0,4171
"024","Vicenza",14,4570,0,0,0,4570,4254,0,0,0,4254
"024","Vicenza",15,4409,0,0,0,4409,4132,0,0,0,4132
"024","Vicenza",16,4320,0,0,0,4320,3986,1,0,0,3987
"024","Vicenza",17,4319,0,0,0,4319,4013,3,0,0,4016
"024","Vicenza",18,4367,0,0,0,4367,4225,7,0,0,4232
"024","Vicenza",19,4623,0,0,0,4623,4136,51,0,0,4187
"024","Vicenza",20,4288,5,0,0,4293,4060,129,2,0,4191
"024","Vicenza",21,4489,22,0,0,4511,3934,202,0,1,4137
"024","Vicenza",22,4483,51,0,0,4534,3893,357,2,0,4252
"024","Vicenza",23,4266,89,1,0,4356,3908,494,1,0,4403
"024","Vicenza",24,4084,167,1,0,4252,3455,643,3,0,4101
"024","Vicenza",25,4112,254,3,0,4369,3346,942,4,0,4292
"024","Vicenza",26,4093,368,2,0,4463,3264,1223,9,1,4497
"024","Vicenza",27,4003,560,1,0,4564,3059,1530,13,2,4604
"024","Vicenza",28,3797,771,6,0,4574,2726,1846,13,3,4588
"024","Vicenza",29,3753,1011,7,1,4772,2708,2138,37,4,4887
"024","Vicenza",30,3594,1330,9,0,4933,2453,2533,39,9,5034
"024","Vicenza",31,3635,1589,18,1,5243,2204,2837,51,7,5099
"024","Vicenza",32,3277,2059,30,2,5368,2110,3088,77,5,5280
"024","Vicenza",33,3393,2440,29,1,5863,2197,3458,96,12,5763
"024","Vicenza",34,3360,2737,54,0,6151,2074,3755,115,19,5963
"024","Vicenza",35,3120,3058,69,0,6247,1870,4121,165,17,6173
"024","Vicenza",36,3198,3402,73,2,6675,1835,4385,193,19,6432
"024","Vicenza",37,3218,3963,95,4,7280,1805,4743,231,25,6804
"024","Vicenza",38,2948,4097,132,7,7184,1652,4888,255,38,6833
"024","Vicenza",39,2734,4487,174,11,7406,1586,4993,248,50,6877
"024","Vicenza",40,2575,4639,212,11,7437,1531,5218,279,48,7076
"024","Vicenza",41,2395,4981,211,10,7597,1356,5267,296,47,6966
"024","Vicenza",42,2281,5152,271,18,7722,1382,5529,326,58,7295
"024","Vicenza",43,2110,5242,249,9,7610,1361,5493,354,77,7285
"024","Vicenza",44,1984,5505,280,26,7795,1176,5512,415,70,7173
"024","Vicenza",45,1844,5640,299,26,7809,1096,5694,399,91,7280
"024","Vicenza",46,1708,5753,331,23,7815,1035,5729,428,112,7304
"024","Vicenza",47,1565,5723,368,28,7684,1032,5736,433,121,7322
"024","Vicenza",48,1324,5346,328,28,7026,899,5477,400,145,6921
"024","Vicenza",49,1213,5241,368,41,6863,857,5097,416,174,6544
"024","Vicenza",50,1114,5160,327,41,6642,775,4986,390,173,6324
"024","Vicenza",51,981,4962,310,39,6292,748,4876,364,188,6176
"024","Vicenza",52,944,4881,296,56,6177,677,4666,356,221,5920
"024","Vicenza",53,835,4508,283,46,5672,601,4396,323,230,5550
"024","Vicenza",54,774,4455,263,59,5551,596,4302,317,230,5445
"024","Vicenza",55,717,4260,241,70,5288,543,4276,291,239,5349
"024","Vicenza",56,680,4252,224,66,5222,468,4163,264,305,5200
"024","Vicenza",57,668,4227,190,89,5174,438,4050,259,332,5079
"024","Vicenza",58,546,4023,222,68,4859,429,4011,224,366,5030
"024","Vicenza",59,547,4126,192,89,4954,406,3925,233,384,4948
"024","Vicenza",60,566,4102,185,82,4935,389,3863,189,439,4880
"024","Vicenza",61,530,4206,199,113,5048,407,4083,197,529,5216
"024","Vicenza",62,466,4172,191,143,4972,382,4030,170,561,5143
"024","Vicenza",63,507,4188,169,139,5003,420,4033,184,666,5303
"024","Vicenza",64,467,3967,151,149,4734,384,3835,168,715,5102
"024","Vicenza",65,475,4487,150,170,5282,379,4204,179,897,5659
"024","Vicenza",66,332,3050,96,142,3620,242,2908,122,701,3973
"024","Vicenza",67,370,3510,97,158,4135,306,3156,117,915,4494
"024","Vicenza",68,373,3610,99,171,4253,300,3355,129,1037,4821
"024","Vicenza",69,360,3399,93,225,4077,346,3054,115,1042,4557
"024","Vicenza",70,381,3340,91,230,4042,319,2995,85,1167,4566
"024","Vicenza",71,359,3513,92,267,4231,327,2994,85,1436,4842
"024","Vicenza",72,370,3437,61,278,4146,303,2715,92,1452,4562
"024","Vicenza",73,324,3233,55,283,3895,346,2472,69,1638,4525
"024","Vicenza",74,273,2802,35,266,3376,306,2137,69,1612,4124
"024","Vicenza",75,229,2437,33,265,2964,330,1919,46,1640,3935
"024","Vicenza",76,246,2426,36,309,3017,311,1724,49,1739,3823
"024","Vicenza",77,241,2282,34,287,2844,333,1572,35,1854,3794
"024","Vicenza",78,203,1898,28,332,2461,293,1296,36,1769,3394
"024","Vicenza",79,200,1852,23,274,2349,331,1208,37,1885,3461
"024","Vicenza",80,165,1731,19,293,2208,306,955,22,1991,3274
"024","Vicenza",81,164,1552,19,321,2056,337,812,26,2122,3297
"024","Vicenza",82,145,1320,15,299,1779,287,679,21,1944,2931
"024","Vicenza",83,128,1162,12,293,1595,307,625,16,2021,2969
"024","Vicenza",84,93,1035,9,293,1430,330,516,18,1910,2774
"024","Vicenza",85,90,860,9,287,1246,317,367,15,1869,2568
"024","Vicenza",86,90,692,6,259,1047,328,306,15,1825,2474
"024","Vicenza",87,60,538,4,243,845,285,227,11,1616,2139
"024","Vicenza",88,51,457,3,236,747,266,168,19,1518,1971
"024","Vicenza",89,46,368,3,194,611,231,128,4,1329,1692
"024","Vicenza",90,26,253,2,171,452,207,81,7,1213,1508
"024","Vicenza",91,35,209,1,117,362,190,47,4,1048,1289
"024","Vicenza",92,12,102,1,89,204,95,16,2,568,681
"024","Vicenza",93,7,58,0,51,116,64,18,5,409,496
"024","Vicenza",94,6,36,1,51,94,57,7,2,302,368
"024","Vicenza",95,6,34,1,24,65,54,4,2,256,316
"024","Vicenza",96,1,23,0,38,62,58,12,1,291,362
"024","Vicenza",97,2,21,0,29,52,47,6,1,231,285
"024","Vicenza",98,1,5,0,17,23,23,5,1,155,184
"024","Vicenza",99,0,3,0,17,20,26,1,1,105,133
"024","Vicenza",100,3,5,0,19,27,26,5,0,158,189
"025","Belluno",0,841,0,0,0,841,800,0,0,0,800
"025","Belluno",1,867,0,0,0,867,849,0,0,0,849
"025","Belluno",2,873,0,0,0,873,815,0,0,0,815
"025","Belluno",3,894,0,0,0,894,876,0,0,0,876
"025","Belluno",4,918,0,0,0,918,788,0,0,0,788
"025","Belluno",5,886,0,0,0,886,887,0,0,0,887
"025","Belluno",6,911,0,0,0,911,834,0,0,0,834
"025","Belluno",7,928,0,0,0,928,866,0,0,0,866
"025","Belluno",8,921,0,0,0,921,858,0,0,0,858
"025","Belluno",9,968,0,0,0,968,911,0,0,0,911
"025","Belluno",10,886,0,0,0,886,832,0,0,0,832
"025","Belluno",11,979,0,0,0,979,956,0,0,0,956
"025","Belluno",12,924,0,0,0,924,896,0,0,0,896
"025","Belluno",13,927,0,0,0,927,896,0,0,0,896
"025","Belluno",14,923,0,0,0,923,853,0,0,0,853
"025","Belluno",15,968,0,0,0,968,912,0,0,0,912
"025","Belluno",16,901,0,0,0,901,846,0,0,0,846
"025","Belluno",17,937,0,0,0,937,887,1,0,0,888
"025","Belluno",18,940,0,0,0,940,882,1,0,0,883
"025","Belluno",19,966,0,0,0,966,970,4,0,0,974
"025","Belluno",20,945,1,0,0,946,866,30,0,0,896
"025","Belluno",21,970,2,0,0,972,898,44,0,0,942
"025","Belluno",22,951,14,1,0,966,846,68,0,0,914
"025","Belluno",23,943,25,0,0,968,859,73,1,0,933
"025","Belluno",24,929,42,0,0,971,788,111,1,1,901
"025","Belluno",25,871,62,1,0,934,776,171,2,0,949
"025","Belluno",26,940,63,1,0,1004,778,189,1,0,968
"025","Belluno",27,922,114,0,0,1036,777,250,1,0,1028
"025","Belluno",28,973,139,0,0,1112,715,306,5,0,1026
"025","Belluno",29,884,191,1,1,1077,697,362,8,0,1067
"025","Belluno",30,922,235,3,0,1160,639,411,7,0,1057
"025","Belluno",31,858,267,1,0,1126,586,457,4,3,1050
"025","Belluno",32,832,351,5,0,1188,555,491,10,0,1056
"025","Belluno",33,849,404,6,0,1259,562,636,19,2,1219
"025","Belluno",34,805,490,3,2,1300,568,698,30,2,1298
"025","Belluno",35,815,552,10,0,1377,574,764,27,1,1366
"025","Belluno",36,777,623,16,1,1417,538,919,39,3,1499
"025","Belluno",37,826,727,25,1,1579,546,926,41,10,1523
"025","Belluno",38,798,783,36,1,1618,477,1046,58,7,1588
"025","Belluno",39,685,902,34,2,1623,495,1089,69,11,1664
"025","Belluno",40,710,935,40,1,1686,450,1090,73,12,1625
"025","Belluno",41,642,979,48,5,1674,433,1146,93,11,1683
"025","Belluno",42,592,1048,58,2,1700,379,1182,83,20,1664
"025","Belluno",43,569,1081,62,5,1717,375,1195,91,25,1686
"025","Belluno",44,514,1121,64,2,1701,357,1243,101,19,1720
"025","Belluno",45,495,1135,74,7,1711,360,1272,100,26,1758
"025","Belluno",46,513,1161,79,3,1756,292,1236,101,26,1655
"025","Belluno",47,432,1187,92,8,1719,311,1313,119,32,1775
"025","Belluno",48,406,1190,77,6,1679,282,1251,105,39,1677
"025","Belluno",49,345,1158,81,13,1597,239,1231,88,40,1598
"025","Belluno",50,373,1152,79,16,1620,248,1208,97,52,1605
"025","Belluno",51,304,1158,73,6,1541,210,1182,94,49,1535
"025","Belluno",52,312,1180,93,13,1598,218,1195,94,66,1573
"025","Belluno",53,297,1064,74,8,1443,192,1098,79,84,1453
"025","Belluno",54,275,1075,71,8,1429,167,1133,86,85,1471
"025","Belluno",55,242,1057,62,20,1381,159,1128,86,87,1460
"025","Belluno",56,247,1099,68,23,1437,168,1146,68,81,1463
"025","Belluno",57,235,1116,61,24,1436,132,1149,77,120,1478
"025","Belluno",58,221,1154,66,20,1461,125,1032,66,127,1350
"025","Belluno",59,200,1071,57,27,1355,143,1087,78,130,1438
"025","Belluno",60,195,1099,47,42,1383,131,1090,57,148,1426
"025","Belluno",61,200,1131,59,41,1431,143,1219,61,182,1605
"025","Belluno",62,207,1130,62,41,1440,107,1060,58,192,1417
"025","Belluno",63,188,1144,43,45,1420,130,1110,55,226,1521
"025","Belluno",64,172,1244,55,65,1536,138,1076,56,263,1533
"025","Belluno",65,197,1234,56,77,1564,113,1145,46,291,1595
"025","Belluno",66,131,845,36,51,1063,94,800,31,224,1149
"025","Belluno",67,136,956,34,59,1185,76,857,37,289,1259
"025","Belluno",68,118,967,30,60,1175,98,844,31,313,1286
"025","Belluno",69,143,905,24,59,1131,98,809,24,367,1298
"025","Belluno",70,142,948,26,71,1187,108,744,38,412,1302
"025","Belluno",71,142,950,26,89,1207,105,775,38,417,1335
"025","Belluno",72,137,981,21,96,1235,108,745,19,481,1353
"025","Belluno",73,117,817,24,98,1056,112,666,23,500,1301
"025","Belluno",74,108,724,9,96,937,102,544,16,484,1146
"025","Belluno",75,91,668,13,77,849,106,488,16,501,1111
"025","Belluno",76,80,581,10,77,748,98,435,14,553,1100
"025","Belluno",77,80,591,8,118,797,88,418,10,562,1078
"025","Belluno",78,72,508,13,101,694,107,312,14,589,1022
"025","Belluno",79,65,472,19,109,665,99,357,12,659,1127
"025","Belluno",80,64,467,8,108,647,99,252,8,672,1031
"025","Belluno",81,57,447,7,91,602,105,260,9,658,1032
"025","Belluno",82,76,402,8,104,590,100,230,6,652,988
"025","Belluno",83,44,335,2,91,472,87,189,6,686,968
"025","Belluno",84,33,314,2,94,443,83,156,7,667,913
"025","Belluno",85,36,260,5,92,393,82,129,7,629,847
"025","Belluno",86,27,187,2,82,298,77,103,4,595,779
"025","Belluno",87,20,170,2,79,271,80,71,2,558,711
"025","Belluno",88,14,155,2,82,253,63,62,8,590,723
"025","Belluno",89,13,124,1,64,202,55,44,2,530,631
"025","Belluno",90,12,112,0,63,187,51,29,2,457,539
"025","Belluno",91,6,67,1,51,125,50,20,1,463,534
"025","Belluno",92,7,26,1,20,54,18,9,2,187,216
"025","Belluno",93,3,20,0,13,36,17,1,0,95,113
"025","Belluno",94,0,15,0,17,32,23,4,0,99,126
"025","Belluno",95,3,7,1,15,26,19,0,2,110,131
"025","Belluno",96,1,7,0,12,20,14,3,0,113,130
"025","Belluno",97,1,4,0,14,19,9,2,0,91,102
"025","Belluno",98,0,1,0,9,10,10,1,0,60,71
"025","Belluno",99,0,3,0,4,7,6,0,0,41,47
"025","Belluno",100,1,2,0,3,6,9,1,0,55,65
"026","Treviso",0,4335,0,0,0,4335,4135,0,0,0,4135
"026","Treviso",1,4616,0,0,0,4616,4272,0,0,0,4272
"026","Treviso",2,4573,0,0,0,4573,4329,0,0,0,4329
"026","Treviso",3,4602,0,0,0,4602,4587,0,0,0,4587
"026","Treviso",4,4740,0,0,0,4740,4492,0,0,0,4492
"026","Treviso",5,4694,0,0,0,4694,4524,0,0,0,4524
"026","Treviso",6,4679,0,0,0,4679,4500,0,0,0,4500
"026","Treviso",7,4752,0,0,0,4752,4309,0,0,0,4309
"026","Treviso",8,4528,0,0,0,4528,4437,0,0,0,4437
"026","Treviso",9,4545,0,0,0,4545,4252,0,0,0,4252
"026","Treviso",10,4419,0,0,0,4419,4100,0,0,0,4100
"026","Treviso",11,4686,0,0,0,4686,4357,0,0,0,4357
"026","Treviso",12,4346,0,0,0,4346,4179,0,0,0,4179
"026","Treviso",13,4415,0,0,0,4415,4180,0,0,0,4180
"026","Treviso",14,4303,0,0,0,4303,4144,0,0,0,4144
"026","Treviso",15,4364,0,0,0,4364,4045,0,0,0,4045
"026","Treviso",16,4175,0,0,0,4175,3836,0,0,0,3836
"026","Treviso",17,4253,0,0,0,4253,3978,4,0,0,3982
"026","Treviso",18,4190,0,0,0,4190,3885,13,0,0,3898
"026","Treviso",19,4214,2,8,0,4224,4077,54,10,0,4141
"026","Treviso",20,4238,7,8,0,4253,3957,151,6,0,4114
"026","Treviso",21,4391,26,8,0,4425,3843,216,5,0,4064
"026","Treviso",22,4164,68,9,0,4241,3823,370,8,0,4201
"026","Treviso",23,4232,86,12,0,4330,3701,538,9,0,4248
"026","Treviso",24,3955,213,19,0,4187,3457,681,14,1,4153
"026","Treviso",25,3990,283,13,0,4286,3313,932,20,2,4267
"026","Treviso",26,4054,426,11,0,4491,3350,1221,19,4,4594
"026","Treviso",27,4009,636,15,0,4660,3157,1448,25,4,4634
"026","Treviso",28,3975,786,22,2,4785,2864,1895,27,5,4791
"026","Treviso",29,3851,1170,26,1,5048,2803,2263,33,8,5107
"026","Treviso",30,3781,1456,10,0,5247,2633,2419,43,8,5103
"026","Treviso",31,3565,1755,23,0,5343,2455,2729,46,5,5235
"026","Treviso",32,3462,2052,19,1,5534,2290,3081,88,11,5470
"026","Treviso",33,3484,2595,38,1,6118,2381,3500,84,8,5973
"026","Treviso",34,3356,2825,41,2,6224,2239,3809,95,13,6156
"026","Treviso",35,3316,3109,52,2,6479,2180,4048,127,19,6374
"026","Treviso",36,3237,3655,79,4,6975,2114,4414,154,22,6704
"026","Treviso",37,3291,4034,102,8,7435,2175,4839,214,37,7265
"026","Treviso",38,3023,4264,119,4,7410,1865,4886,195,33,6979
"026","Treviso",39,2852,4479,128,9,7468,1870,4946,239,28,7083
"026","Treviso",40,2705,4648,161,7,7521,1679,5425,311,35,7450
"026","Treviso",41,2468,4961,174,7,7610,1591,5465,274,45,7375
"026","Treviso",42,2296,5284,217,18,7815,1506,5641,335,51,7533
"026","Treviso",43,2135,5183,221,17,7556,1408,5558,363,71,7400
"026","Treviso",44,1968,5485,233,17,7703,1349,5685,371,93,7498
"026","Treviso",45,1925,5665,291,15,7896,1258,5661,407,76,7402
"026","Treviso",46,1692,5786,302,36,7816,1218,5825,399,106,7548
"026","Treviso",47,1571,5836,305,44,7756,1105,5774,425,105,7409
"026","Treviso",48,1367,5499,286,16,7168,998,5456,382,125,6961
"026","Treviso",49,1192,5400,313,38,6943,868,5214,377,163,6622
"026","Treviso",50,1151,5268,285,46,6750,830,5260,369,169,6628
"026","Treviso",51,1000,5127,278,49,6454,762,5010,361,162,6295
"026","Treviso",52,938,5044,274,54,6310,701,5085,318,236,6340
"026","Treviso",53,833,4752,239,54,5878,594,4842,320,225,5981
"026","Treviso",54,757,4697,217,61,5732,564,4517,300,244,5625
"026","Treviso",55,716,4574,212,63,5565,546,4494,310,262,5612
"026","Treviso",56,627,4561,239,84,5511,538,4502,278,307,5625
"026","Treviso",57,629,4469,201,86,5385,459,4352,288,333,5432
"026","Treviso",58,556,4370,198,91,5215,421,4240,271,380,5312
"026","Treviso",59,534,4188,176,100,4998,426,4114,221,398,5159
"026","Treviso",60,506,4185,175,94,4960,342,4073,211,423,5049
"026","Treviso",61,509,4337,152,115,5113,362,4212,218,495,5287
"026","Treviso",62,452,4286,163,125,5026,347,3996,208,533,5084
"026","Treviso",63,479,4330,173,161,5143,316,4163,187,611,5277
"026","Treviso",64,413,4231,137,166,4947,327,4044,194,720,5285
"026","Treviso",65,475,4616,140,182,5413,325,4345,163,884,5717
"026","Treviso",66,298,3179,100,131,3708,233,3018,111,674,4036
"026","Treviso",67,335,3668,110,193,4306,262,3345,122,920,4649
"026","Treviso",68,373,3633,86,209,4301,262,3311,119,1013,4705
"026","Treviso",69,326,3418,75,214,4033,280,3060,104,1053,4497
"026","Treviso",70,363,3332,69,232,3996,263,2967,90,1205,4525
"026","Treviso",71,322,3578,70,277,4247,265,3082,105,1345,4797
"026","Treviso",72,332,3538,71,255,4196,273,2874,70,1468,4685
"026","Treviso",73,292,3231,54,293,3870,252,2605,81,1565,4503
"026","Treviso",74,257,2841,39,289,3426,276,2243,68,1570,4157
"026","Treviso",75,236,2632,36,259,3163,270,1898,49,1671,3888
"026","Treviso",76,253,2547,43,296,3139,280,1795,52,1778,3905
"026","Treviso",77,192,2315,34,283,2824,250,1623,36,1830,3739
"026","Treviso",78,198,1947,34,272,2451,256,1343,45,1758,3402
"026","Treviso",79,177,1857,24,290,2348,267,1175,38,1931,3411
"026","Treviso",80,157,1718,18,305,2198,245,1122,40,1964,3371
"026","Treviso",81,156,1662,20,303,2141,252,1010,37,2176,3475
"026","Treviso",82,152,1431,13,302,1898,252,731,31,2014,3028
"026","Treviso",83,132,1269,10,288,1699,255,737,26,2120,3138
"026","Treviso",84,99,1147,15,339,1600,292,581,21,2174,3068
"026","Treviso",85,99,931,13,288,1331,262,450,21,2097,2830
"026","Treviso",86,88,820,7,252,1167,241,377,16,1979,2613
"026","Treviso",87,84,652,5,299,1040,243,253,13,1843,2352
"026","Treviso",88,58,540,4,281,883,199,208,13,1779,2199
"026","Treviso",89,46,411,9,241,707,190,133,11,1577,1911
"026","Treviso",90,27,301,2,186,516,151,91,7,1370,1619
"026","Treviso",91,21,242,6,156,425,117,40,8,1193,1358
"026","Treviso",92,15,99,0,85,199,75,25,5,560,665
"026","Treviso",93,2,48,0,41,91,48,12,1,324,385
"026","Treviso",94,2,40,0,54,96,41,6,1,309,357
"026","Treviso",95,2,50,0,39,91,53,8,3,343,407
"026","Treviso",96,10,32,0,49,91,55,4,4,370,433
"026","Treviso",97,4,23,0,38,65,46,3,1,247,297
"026","Treviso",98,2,8,0,25,35,31,2,1,196,230
"026","Treviso",99,3,9,0,16,28,24,1,0,141,166
"026","Treviso",100,2,2,1,23,28,30,1,0,200,231
"027","Venezia",0,3649,0,0,0,3649,3586,0,0,0,3586
"027","Venezia",1,3728,0,0,0,3728,3575,0,0,0,3575
"027","Venezia",2,3865,0,0,0,3865,3535,0,0,0,3535
"027","Venezia",3,3924,0,0,0,3924,3682,0,0,0,3682
"027","Venezia",4,3946,0,0,0,3946,3725,0,0,0,3725
"027","Venezia",5,3876,0,0,0,3876,3664,0,0,0,3664
"027","Venezia",6,3849,0,0,0,3849,3573,0,0,0,3573
"027","Venezia",7,3903,0,0,0,3903,3762,0,0,0,3762
"027","Venezia",8,3991,0,0,0,3991,3615,0,0,0,3615
"027","Venezia",9,3780,0,0,0,3780,3520,0,0,0,3520
"027","Venezia",10,3895,0,0,0,3895,3554,0,0,0,3554
"027","Venezia",11,3941,0,0,0,3941,3633,0,0,0,3633
"027","Venezia",12,3774,0,0,0,3774,3625,0,0,0,3625
"027","Venezia",13,3811,0,0,0,3811,3707,0,0,0,3707
"027","Venezia",14,3684,0,0,0,3684,3648,0,0,0,3648
"027","Venezia",15,3592,0,0,0,3592,3413,0,0,0,3413
"027","Venezia",16,3662,1,0,0,3663,3288,0,0,0,3288
"027","Venezia",17,3587,1,0,0,3588,3323,1,0,0,3324
"027","Venezia",18,3561,0,0,0,3561,3481,13,0,0,3494
"027","Venezia",19,3749,3,0,0,3752,3542,43,1,0,3586
"027","Venezia",20,3748,4,0,0,3752,3459,98,0,0,3557
"027","Venezia",21,3859,28,0,0,3887,3482,170,0,0,3652
"027","Venezia",22,3599,42,1,0,3642,3410,292,0,0,3702
"027","Venezia",23,3786,72,3,0,3861,3336,378,0,2,3716
"027","Venezia",24,3660,148,4,0,3812,3171,521,5,7,3704
"027","Venezia",25,3596,230,8,0,3834,3180,725,5,2,3912
"027","Venezia",26,3737,303,4,0,4044,3148,919,7,2,4076
"027","Venezia",27,3660,413,12,1,4086,2865,1117,13,1,3996
"027","Venezia",28,3653,604,11,1,4269,2889,1310,16,3,4218
"027","Venezia",29,3553,838,16,1,4408,2704,1700,18,7,4429
"027","Venezia",30,3390,1100,17,1,4508,2412,1978,26,3,4419
"027","Venezia",31,3271,1364,13,0,4648,2317,2240,26,7,4590
"027","Venezia",32,3299,1774,22,0,5095,2297,2569,51,8,4925
"027","Venezia",33,3457,1992,28,2,5479,2305,2794,66,10,5175
"027","Venezia",34,3261,2282,26,4,5573,2375,3223,77,20,5695
"027","Venezia",35,3372,2727,37,3,6139,2220,3557,115,8,5900
"027","Venezia",36,3229,3082,63,5,6379,2293,3886,113,24,6316
"027","Venezia",37,3234,3488,73,6,6801,2269,4250,165,22,6706
"027","Venezia",38,3002,3695,95,7,6799,2124,4452,170,33,6779
"027","Venezia",39,2956,3966,144,7,7073,1989,4618,175,45,6827
"027","Venezia",40,2746,4179,120,12,7057,1754,4889,256,51,6950
"027","Venezia",41,2374,4426,153,8,6961,1684,5062,239,44,7029
"027","Venezia",42,2297,4742,212,10,7261,1554,5231,244,76,7105
"027","Venezia",43,2145,4780,189,14,7128,1437,5297,305,106,7145
"027","Venezia",44,2049,4956,179,21,7205,1426,5432,336,86,7280
"027","Venezia",45,1821,5181,228,25,7255,1380,5524,333,100,7337
"027","Venezia",46,1738,5285,229,24,7276,1267,5667,328,116,7378
"027","Venezia",47,1597,5591,283,32,7503,1184,5986,352,164,7686
"027","Venezia",48,1439,5170,293,29,6931,1029,5647,402,152,7230
"027","Venezia",49,1294,5161,280,55,6790,992,5542,346,183,7063
"027","Venezia",50,1146,5164,266,47,6623,907,5376,416,195,6894
"027","Venezia",51,1009,5016,222,52,6299,772,5187,354,203,6516
"027","Venezia",52,939,5036,289,54,6318,759,5187,350,249,6545
"027","Venezia",53,841,4641,268,58,5808,647,4895,308,259,6109
"027","Venezia",54,767,4560,253,63,5643,684,4872,303,289,6148
"027","Venezia",55,691,4582,209,71,5553,635,4720,284,354,5993
"027","Venezia",56,665,4387,217,64,5333,530,4531,340,316,5717
"027","Venezia",57,572,4377,224,93,5266,506,4573,262,377,5718
"027","Venezia",58,542,4408,202,98,5250,451,4255,273,398,5377
"027","Venezia",59,500,4247,196,130,5073,421,4323,237,483,5464
"027","Venezia",60,470,4176,162,108,4916,387,4252,226,470,5335
"027","Venezia",61,510,4339,147,124,5120,397,4453,233,586,5669
"027","Venezia",62,445,4586,190,167,5388,378,4443,213,626,5660
"027","Venezia",63,473,4681,156,157,5467,362,4548,195,766,5871
"027","Venezia",64,426,4723,154,173,5476,372,4464,204,884,5924
"027","Venezia",65,458,5077,168,220,5923,373,4705,181,1019,6278
"027","Venezia",66,294,3325,106,171,3896,256,3203,153,771,4383
"027","Venezia",67,385,4099,113,212,4809,290,3711,138,1028,5167
"027","Venezia",68,365,4029,94,236,4724,325,3650,138,1142,5255
"027","Venezia",69,404,3843,101,279,4627,310,3509,132,1232,5183
"027","Venezia",70,377,3912,80,286,4655,308,3317,120,1356,5101
"027","Venezia",71,328,4031,76,298,4733,313,3539,126,1589,5567
"027","Venezia",72,364,3787,71,326,4548,305,3122,113,1691,5231
"027","Venezia",73,296,3481,65,378,4220,314,2915,88,1879,5196
"027","Venezia",74,284,3229,65,326,3904,285,2517,82,1871,4755
"027","Venezia",75,241,2774,40,341,3396,294,2260,66,1955,4575
"027","Venezia",76,211,2893,47,380,3531,294,2064,77,1991,4426
"027","Venezia",77,219,2630,37,377,3263,264,1809,59,2169,4301
"027","Venezia",78,196,2282,32,363,2873,231,1507,54,2130,3922
"027","Venezia",79,152,2194,23,396,2765,270,1400,40,2199,3909
"027","Venezia",80,166,1946,17,386,2515,298,1218,39,2231,3786
"027","Venezia",81,163,1836,20,378,2397,310,1056,43,2429,3838
"027","Venezia",82,146,1420,19,385,1970,292,800,36,2257,3385
"027","Venezia",83,113,1354,14,380,1861,285,717,27,2361,3390
"027","Venezia",84,105,1198,10,370,1683,277,599,26,2294,3196
"027","Venezia",85,84,994,8,354,1440,252,497,30,2176,2955
"027","Venezia",86,66,786,9,349,1210,215,375,22,2025,2637
"027","Venezia",87,51,615,11,285,962,223,305,19,1853,2400
"027","Venezia",88,45,534,8,324,911,185,215,17,1854,2271
"027","Venezia",89,27,437,4,278,746,185,143,13,1549,1890
"027","Venezia",90,27,323,0,229,579,140,105,12,1366,1623
"027","Venezia",91,24,248,4,187,463,140,55,13,1204,1412
"027","Venezia",92,10,135,0,93,238,59,28,5,661,753
"027","Venezia",93,8,54,0,62,124,32,11,4,395,442
"027","Venezia",94,3,46,0,65,114,36,8,3,346,393
"027","Venezia",95,6,24,0,57,87,35,8,2,283,328
"027","Venezia",96,2,31,0,49,82,28,9,0,351,388
"027","Venezia",97,4,17,0,45,66,31,3,2,255,291
"027","Venezia",98,0,17,0,31,48,18,2,2,183,205
"027","Venezia",99,2,8,0,25,35,11,1,0,102,114
"027","Venezia",100,1,10,1,17,29,19,0,1,175,195
"028","Padova",0,4399,0,0,0,4399,4147,0,0,0,4147
"028","Padova",1,4449,0,0,0,4449,4291,0,0,0,4291
"028","Padova",2,4522,0,0,0,4522,4425,0,0,0,4425
"028","Padova",3,4668,0,0,0,4668,4414,0,0,0,4414
"028","Padova",4,4451,0,0,0,4451,4377,0,0,0,4377
"028","Padova",5,4545,0,0,0,4545,4332,0,0,0,4332
"028","Padova",6,4445,0,0,0,4445,4136,0,0,0,4136
"028","Padova",7,4471,0,0,0,4471,4289,0,0,0,4289
"028","Padova",8,4495,0,0,0,4495,4171,0,0,0,4171
"028","Padova",9,4334,0,0,0,4334,4011,0,0,0,4011
"028","Padova",10,4268,0,0,0,4268,4173,0,0,0,4173
"028","Padova",11,4450,0,0,0,4450,4278,0,0,0,4278
"028","Padova",12,4431,0,0,0,4431,4146,0,0,0,4146
"028","Padova",13,4379,0,0,0,4379,4114,0,0,0,4114
"028","Padova",14,4328,0,0,0,4328,4028,0,0,0,4028
"028","Padova",15,4264,0,0,0,4264,4090,0,0,0,4090
"028","Padova",16,4207,0,0,0,4207,3974,0,0,0,3974
"028","Padova",17,4250,0,0,0,4250,3859,2,0,0,3861
"028","Padova",18,4252,0,0,0,4252,4044,7,0,0,4051
"028","Padova",19,4474,1,0,0,4475,4127,46,0,0,4173
"028","Padova",20,4448,8,0,0,4456,4078,108,0,0,4186
"028","Padova",21,4329,13,0,0,4342,4156,180,2,0,4338
"028","Padova",22,4355,38,0,1,4394,3968,271,0,0,4239
"028","Padova",23,4473,83,0,0,4556,4001,459,2,0,4462
"028","Padova",24,4286,154,1,0,4441,3666,617,1,0,4284
"028","Padova",25,4132,229,0,0,4361,3610,795,9,1,4415
"028","Padova",26,4410,371,2,0,4783,3742,1115,10,2,4869
"028","Padova",27,4278,508,6,0,4792,3579,1315,16,1,4911
"028","Padova",28,4274,741,5,0,5020,3310,1586,10,5,4911
"028","Padova",29,4091,1007,4,1,5103,3324,2018,17,5,5364
"028","Padova",30,3943,1276,2,1,5222,3030,2362,28,8,5428
"028","Padova",31,4049,1667,9,0,5725,2878,2769,32,8,5687
"028","Padova",32,3915,2026,14,3,5958,2782,3080,65,9,5936
"028","Padova",33,3781,2322,20,3,6126,2687,3457,74,10,6228
"028","Padova",34,3760,2659,30,4,6453,2668,3869,107,11,6655
"028","Padova",35,3748,3206,38,2,6994,2469,4228,133,17,6847
"028","Padova",36,3735,3516,64,6,7321,2414,4340,145,25,6924
"028","Padova",37,3507,4005,85,5,7602,2486,4888,172,28,7574
"028","Padova",38,3327,4244,96,6,7673,2288,5009,206,36,7539
"028","Padova",39,3218,4423,121,12,7774,2125,5041,262,44,7472
"028","Padova",40,2911,4719,177,15,7822,2095,5296,237,49,7677
"028","Padova",41,2791,4967,191,3,7952,1867,5501,344,47,7759
"028","Padova",42,2619,5316,216,15,8166,1742,5803,316,68,7929
"028","Padova",43,2372,5486,249,6,8113,1716,5781,355,80,7932
"028","Padova",44,2295,5474,253,16,8038,1623,5803,384,74,7884
"028","Padova",45,2115,5588,279,26,8008,1491,6053,353,92,7989
"028","Padova",46,1922,5902,315,27,8166,1446,6145,375,115,8081
"028","Padova",47,1803,6024,327,22,8176,1394,6272,455,155,8276
"028","Padova",48,1571,5890,321,22,7804,1204,5878,364,135,7581
"028","Padova",49,1412,5727,310,40,7489,1170,5714,365,151,7400
"028","Padova",50,1355,5454,299,48,7156,1065,5592,400,154,7211
"028","Padova",51,1109,5190,273,39,6611,979,5325,354,181,6839
"028","Padova",52,1062,5379,300,45,6786,968,5241,347,205,6761
"028","Padova",53,972,5146,292,44,6454,889,4977,323,237,6426
"028","Padova",54,906,5105,256,63,6330,805,4845,321,268,6239
"028","Padova",55,806,4928,259,76,6069,781,4953,327,309,6370
"028","Padova",56,725,4551,231,78,5585,714,4640,270,309,5933
"028","Padova",57,723,4725,225,92,5765,604,4583,271,345,5803
"028","Padova",58,604,4491,202,89,5386,560,4503,285,359,5707
"028","Padova",59,607,4431,178,96,5312,502,4486,236,422,5646
"028","Padova",60,551,4500,193,98,5342,513,4294,247,506,5560
"028","Padova",61,533,4587,157,110,5387,490,4610,217,563,5880
"028","Padova",62,505,4624,180,127,5436,480,4400,180,599,5659
"028","Padova",63,499,4588,149,160,5396,451,4509,225,698,5883
"028","Padova",64,454,4478,147,157,5236,406,4204,186,790,5586
"028","Padova",65,488,4809,153,198,5648,405,4489,191,903,5988
"028","Padova",66,328,3386,113,152,3979,326,3298,145,735,4504
"028","Padova",67,385,3975,105,155,4620,332,3541,131,911,4915
"028","Padova",68,407,3955,76,237,4675,356,3557,129,1126,5168
"028","Padova",69,392,3704,96,243,4435,394,3363,139,1088,4984
"028","Padova",70,374,3666,72,245,4357,334,3208,104,1336,4982
"028","Padova",71,382,3801,87,283,4553,350,3345,121,1481,5297
"028","Padova",72,361,3698,71,288,4418,355,3026,82,1597,5060
"028","Padova",73,297,3535,49,292,4173,404,2837,99,1764,5104
"028","Padova",74,294,3042,55,291,3682,320,2448,78,1746,4592
"028","Padova",75,294,2771,48,295,3408,349,2167,73,1846,4435
"028","Padova",76,259,2799,34,364,3456,317,2142,56,2086,4601
"028","Padova",77,235,2647,24,302,3208,345,1816,55,2116,4332
"028","Padova",78,236,2366,24,351,2977,337,1538,39,2108,4022
"028","Padova",79,212,2134,20,348,2714,312,1374,41,2171,3898
"028","Padova",80,161,1957,21,347,2486,334,1130,33,2297,3794
"028","Padova",81,187,1843,15,341,2386,357,1058,35,2374,3824
"028","Padova",82,132,1534,11,352,2029,316,814,27,2194,3351
"028","Padova",83,150,1357,15,361,1883,320,700,24,2351,3395
"028","Padova",84,126,1274,9,337,1746,316,651,25,2332,3324
"028","Padova",85,82,978,8,305,1373,296,504,24,2192,3016
"028","Padova",86,88,869,5,313,1275,285,383,22,2053,2743
"028","Padova",87,55,668,4,320,1047,254,282,11,1842,2389
"028","Padova",88,54,557,8,277,896,232,197,14,1733,2176
"028","Padova",89,35,423,2,247,707,187,141,23,1479,1830
"028","Padova",90,36,335,2,197,570,146,104,7,1330,1587
"028","Padova",91,28,214,1,174,417,149,48,5,1122,1324
"028","Padova",92,13,134,3,84,234,84,26,4,691,805
"028","Padova",93,13,64,0,68,145,52,14,2,411,479
"028","Padova",94,6,51,1,48,106,41,16,1,367,425
"028","Padova",95,8,41,1,50,100,47,11,1,336,395
"028","Padova",96,5,32,0,50,87,44,13,1,312,370
"028","Padova",97,5,23,0,41,69,41,3,0,277,321
"028","Padova",98,2,14,0,30,46,24,2,0,202,228
"028","Padova",99,1,11,0,19,31,15,2,0,124,141
"028","Padova",100,1,5,0,21,27,24,1,1,182,208
"029","Rovigo",0,899,0,0,0,899,913,0,0,0,913
"029","Rovigo",1,1033,0,0,0,1033,908,0,0,0,908
"029","Rovigo",2,1017,0,0,0,1017,930,0,0,0,930
"029","Rovigo",3,1019,0,0,0,1019,932,0,0,0,932
"029","Rovigo",4,935,0,0,0,935,928,0,0,0,928
"029","Rovigo",5,947,0,0,0,947,868,0,0,0,868
"029","Rovigo",6,984,0,0,0,984,883,0,0,0,883
"029","Rovigo",7,939,0,0,0,939,903,0,0,0,903
"029","Rovigo",8,915,0,0,0,915,873,0,0,0,873
"029","Rovigo",9,905,0,0,0,905,848,0,0,0,848
"029","Rovigo",10,927,0,0,0,927,829,0,0,0,829
"029","Rovigo",11,971,0,0,0,971,910,0,0,0,910
"029","Rovigo",12,907,0,0,0,907,896,0,0,0,896
"029","Rovigo",13,933,0,0,0,933,914,0,0,0,914
"029","Rovigo",14,989,0,0,0,989,936,0,0,0,936
"029","Rovigo",15,963,0,0,0,963,933,0,0,0,933
"029","Rovigo",16,964,0,0,0,964,869,0,0,0,869
"029","Rovigo",17,994,0,0,0,994,884,0,0,0,884
"029","Rovigo",18,950,1,0,0,951,867,3,0,0,870
"029","Rovigo",19,1065,0,0,0,1065,963,7,0,0,970
"029","Rovigo",20,1041,1,0,0,1042,1034,30,0,0,1064
"029","Rovigo",21,1091,5,0,0,1096,1079,40,0,0,1119
"029","Rovigo",22,1080,7,0,0,1087,992,65,0,0,1057
"029","Rovigo",23,1156,14,0,0,1170,1042,87,0,0,1129
"029","Rovigo",24,1143,25,0,0,1168,949,104,0,0,1053
"029","Rovigo",25,1135,40,0,0,1175,967,156,2,0,1125
"029","Rovigo",26,1154,46,0,0,1200,1023,209,0,2,1234
"029","Rovigo",27,1130,103,1,0,1234,921,292,2,2,1217
"029","Rovigo",28,1185,153,0,0,1338,855,331,2,1,1189
"029","Rovigo",29,1073,199,2,0,1274,855,489,5,0,1349
"029","Rovigo",30,1049,256,2,0,1307,872,535,5,4,1416
"029","Rovigo",31,1085,337,0,1,1423,784,619,12,1,1416
"029","Rovigo",32,1040,441,4,0,1485,742,708,14,4,1468
"029","Rovigo",33,1125,550,6,0,1681,806,844,13,6,1669
"029","Rovigo",34,1054,642,8,1,1705,712,888,29,9,1638
"029","Rovigo",35,1097,757,5,1,1860,686,965,24,6,1681
"029","Rovigo",36,1034,819,12,0,1865,655,1103,38,3,1799
"029","Rovigo",37,985,944,20,0,1949,637,1141,53,7,1838
"029","Rovigo",38,889,971,37,1,1898,588,1243,44,13,1888
"029","Rovigo",39,850,1020,37,0,1907,527,1190,56,13,1786
"029","Rovigo",40,763,1081,44,1,1889,463,1287,74,8,1832
"029","Rovigo",41,746,1110,50,4,1910,422,1325,68,11,1826
"029","Rovigo",42,654,1196,62,2,1914,419,1319,94,24,1856
"029","Rovigo",43,622,1291,55,2,1970,328,1429,80,29,1866
"029","Rovigo",44,570,1358,50,11,1989,368,1468,81,28,1945
"029","Rovigo",45,488,1452,72,8,2020,346,1525,97,33,2001
"029","Rovigo",46,491,1402,83,9,1985,315,1526,89,31,1961
"029","Rovigo",47,459,1483,90,9,2041,321,1585,99,36,2041
"029","Rovigo",48,434,1434,75,11,1954,258,1588,100,38,1984
"029","Rovigo",49,384,1472,60,11,1927,251,1559,91,65,1966
"029","Rovigo",50,361,1485,87,16,1949,234,1586,103,66,1989
"029","Rovigo",51,375,1444,69,5,1893,182,1535,83,53,1853
"029","Rovigo",52,311,1493,76,17,1897,185,1586,82,71,1924
"029","Rovigo",53,254,1499,54,10,1817,177,1417,95,81,1770
"029","Rovigo",54,242,1471,69,15,1797,173,1549,81,92,1895
"029","Rovigo",55,240,1478,76,17,1811,185,1489,79,112,1865
"029","Rovigo",56,200,1449,51,26,1726,174,1475,64,110,1823
"029","Rovigo",57,184,1392,68,23,1667,151,1420,61,146,1778
"029","Rovigo",58,160,1457,53,33,1703,130,1417,65,145,1757
"029","Rovigo",59,159,1430,61,45,1695,128,1359,64,129,1680
"029","Rovigo",60,165,1375,51,38,1629,130,1221,50,147,1548
"029","Rovigo",61,187,1414,61,53,1715,119,1318,46,192,1675
"029","Rovigo",62,163,1403,34,47,1647,125,1322,38,209,1694
"029","Rovigo",63,161,1507,36,55,1759,105,1334,47,253,1739
"029","Rovigo",64,162,1381,41,65,1649,109,1255,42,230,1636
"029","Rovigo",65,139,1411,25,84,1659,90,1247,37,307,1681
"029","Rovigo",66,88,876,19,50,1033,50,765,27,227,1069
"029","Rovigo",67,113,1053,31,51,1248,74,1012,18,304,1408
"029","Rovigo",68,104,1033,19,66,1222,80,912,25,288,1305
"029","Rovigo",69,89,978,20,66,1153,88,902,18,373,1381
"029","Rovigo",70,129,1059,27,67,1282,80,888,21,381,1370
"029","Rovigo",71,123,995,7,69,1194,93,894,18,459,1464
"029","Rovigo",72,113,991,18,93,1215,87,832,18,479,1416
"029","Rovigo",73,122,1023,16,113,1274,79,822,19,529,1449
"029","Rovigo",74,103,891,10,101,1105,82,759,13,549,1403
"029","Rovigo",75,86,756,4,90,936,83,630,7,587,1307
"029","Rovigo",76,125,879,13,120,1137,67,612,5,692,1376
"029","Rovigo",77,101,836,8,113,1058,81,595,6,729,1411
"029","Rovigo",78,80,724,14,116,934,91,544,6,757,1398
"029","Rovigo",79,68,633,7,99,807,91,450,9,719,1269
"029","Rovigo",80,70,629,7,113,819,100,410,5,826,1341
"029","Rovigo",81,65,579,8,121,773,101,386,12,880,1379
"029","Rovigo",82,54,488,7,134,683,88,288,8,731,1115
"029","Rovigo",83,33,439,4,119,595,112,249,3,803,1167
"029","Rovigo",84,49,398,7,129,583,77,197,7,860,1141
"029","Rovigo",85,29,322,1,133,485,67,151,5,762,985
"029","Rovigo",86,31,287,2,146,466,101,151,4,715,971
"029","Rovigo",87,13,206,1,102,322,85,110,6,594,795
"029","Rovigo",88,27,176,1,110,314,59,71,4,620,754
"029","Rovigo",89,11,134,2,89,236,66,49,1,540,656
"029","Rovigo",90,2,92,1,74,169,45,25,1,451,522
"029","Rovigo",91,6,79,0,67,152,39,24,0,395,458
"029","Rovigo",92,4,39,0,42,85,32,8,2,195,237
"029","Rovigo",93,1,17,1,26,45,12,4,0,105,121
"029","Rovigo",94,2,9,0,19,30,15,3,0,96,114
"029","Rovigo",95,1,7,0,18,26,15,3,0,83,101
"029","Rovigo",96,0,11,0,19,30,12,2,0,99,113
"029","Rovigo",97,0,8,0,26,34,5,2,0,82,89
"029","Rovigo",98,0,2,0,11,13,10,2,0,51,63
"029","Rovigo",99,1,4,0,7,12,6,0,0,34,40
"029","Rovigo",100,1,3,0,7,11,4,1,0,43,48
"030","Udine",0,2093,0,0,0,2093,2056,0,0,0,2056
"030","Udine",1,2281,0,0,0,2281,2132,0,0,0,2132
"030","Udine",2,2219,0,0,0,2219,2266,0,0,0,2266
"030","Udine",3,2209,0,0,0,2209,2194,0,0,0,2194
"030","Udine",4,2272,0,0,0,2272,2220,0,0,0,2220
"030","Udine",5,2321,0,0,0,2321,2233,0,0,0,2233
"030","Udine",6,2325,0,0,0,2325,2221,0,0,0,2221
"030","Udine",7,2257,0,0,0,2257,2221,0,0,0,2221
"030","Udine",8,2382,0,0,0,2382,2175,0,0,0,2175
"030","Udine",9,2294,0,0,0,2294,2189,0,0,0,2189
"030","Udine",10,2295,0,0,0,2295,2175,0,0,0,2175
"030","Udine",11,2364,0,0,0,2364,2245,0,0,0,2245
"030","Udine",12,2262,0,0,0,2262,2109,0,0,0,2109
"030","Udine",13,2292,0,0,0,2292,2134,0,0,0,2134
"030","Udine",14,2215,0,0,0,2215,2111,0,0,0,2111
"030","Udine",15,2272,0,0,0,2272,2057,0,0,0,2057
"030","Udine",16,2197,0,0,0,2197,2097,0,0,0,2097
"030","Udine",17,2168,1,0,0,2169,2040,2,0,0,2042
"030","Udine",18,2169,0,0,0,2169,2019,8,0,0,2027
"030","Udine",19,2281,0,0,0,2281,2203,28,0,0,2231
"030","Udine",20,2229,7,0,0,2236,2201,61,0,0,2262
"030","Udine",21,2328,11,0,0,2339,2161,111,0,0,2272
"030","Udine",22,2319,26,0,0,2345,2170,154,1,0,2325
"030","Udine",23,2324,66,0,0,2390,2207,231,1,1,2440
"030","Udine",24,2239,87,0,0,2326,1955,322,0,1,2278
"030","Udine",25,2285,156,0,0,2441,1996,432,1,1,2430
"030","Udine",26,2421,197,1,0,2619,1995,634,6,0,2635
"030","Udine",27,2521,300,1,0,2822,2024,643,6,0,2673
"030","Udine",28,2332,423,0,0,2755,1862,837,11,2,2712
"030","Udine",29,2400,573,5,0,2978,1732,1064,13,3,2812
"030","Udine",30,2300,721,4,0,3025,1626,1195,14,2,2837
"030","Udine",31,2266,883,7,0,3156,1553,1359,34,1,2947
"030","Udine",32,2250,1092,4,0,3346,1528,1532,37,6,3103
"030","Udine",33,2258,1248,17,1,3524,1562,1743,49,3,3357
"030","Udine",34,2119,1357,27,0,3503,1472,1924,72,5,3473
"030","Udine",35,2036,1535,21,1,3593,1446,2040,80,16,3582
"030","Udine",36,2141,1799,32,3,3975,1359,2301,127,16,3803
"030","Udine",37,2094,2062,60,2,4218,1392,2540,156,18,4106
"030","Udine",38,1931,2118,71,10,4130,1351,2618,133,19,4121
"030","Udine",39,1865,2262,89,1,4217,1193,2754,186,30,4163
"030","Udine",40,1738,2425,107,3,4273,1119,2910,191,40,4260
"030","Udine",41,1646,2563,130,5,4344,1071,3048,215,35,4369
"030","Udine",42,1601,2725,155,12,4493,1024,3085,234,41,4384
"030","Udine",43,1432,2817,157,8,4414,917,3037,233,57,4244
"030","Udine",44,1353,2890,215,13,4471,874,3187,291,41,4393
"030","Udine",45,1231,2956,222,17,4426,873,3204,313,64,4454
"030","Udine",46,1276,3063,244,13,4596,816,3270,272,74,4432
"030","Udine",47,1206,3137,234,15,4592,781,3312,358,76,4527
"030","Udine",48,1069,2982,219,16,4286,669,3374,342,113,4498
"030","Udine",49,946,2907,270,27,4150,570,3154,334,105,4163
"030","Udine",50,814,2966,256,23,4059,572,3011,311,123,4017
"030","Udine",51,773,2952,233,25,3983,514,2981,298,135,3928
"030","Udine",52,747,2943,255,36,3981,486,3001,328,143,3958
"030","Udine",53,667,2760,248,41,3716,407,2896,261,186,3750
"030","Udine",54,603,2643,227,49,3522,356,2851,273,171,3651
"030","Udine",55,589,2678,210,43,3520,352,2844,252,229,3677
"030","Udine",56,560,2669,209,52,3490,348,2750,236,248,3582
"030","Udine",57,494,2710,202,58,3464,308,2793,241,272,3614
"030","Udine",58,463,2686,200,67,3416,283,2771,217,337,3608
"030","Udine",59,419,2636,181,67,3303,264,2763,214,331,3572
"030","Udine",60,478,2552,163,60,3253,255,2696,170,417,3538
"030","Udine",61,469,2850,181,102,3602,247,2850,168,430,3695
"030","Udine",62,446,2781,169,114,3510,253,2798,206,507,3764
"030","Udine",63,446,2988,142,122,3698,263,2878,186,557,3884
"030","Udine",64,410,2990,140,127,3667,264,2886,166,624,3940
"030","Udine",65,443,3246,123,167,3979,217,3040,151,782,4190
"030","Udine",66,295,2232,96,127,2750,184,2092,117,586,2979
"030","Udine",67,345,2684,99,150,3278,197,2330,130,770,3427
"030","Udine",68,338,2550,105,177,3170,201,2260,139,799,3399
"030","Udine",69,326,2485,103,178,3092,217,2300,95,915,3527
"030","Udine",70,343,2557,84,205,3189,214,2114,84,1012,3424
"030","Udine",71,355,2594,91,225,3265,229,2093,81,1165,3568
"030","Udine",72,293,2518,75,209,3095,230,2003,87,1177,3497
"030","Udine",73,265,2332,58,249,2904,211,1777,75,1248,3311
"030","Udine",74,242,1961,58,253,2514,214,1476,74,1253,3017
"030","Udine",75,208,1830,34,237,2309,170,1348,54,1305,2877
"030","Udine",76,174,1640,50,234,2098,188,1235,47,1374,2844
"030","Udine",77,172,1538,40,226,1976,225,1008,41,1405,2679
"030","Udine",78,186,1383,22,258,1849,199,878,31,1406,2514
"030","Udine",79,167,1249,30,233,1679,178,819,37,1482,2516
"030","Udine",80,139,1219,15,248,1621,200,713,29,1478,2420
"030","Udine",81,154,1122,20,239,1535,201,621,27,1632,2481
"030","Udine",82,119,975,11,243,1348,166,506,27,1503,2202
"030","Udine",83,96,821,17,238,1172,184,425,26,1594,2229
"030","Udine",84,87,761,9,262,1119,180,374,25,1594,2173
"030","Udine",85,71,660,9,234,974,163,310,16,1618,2107
"030","Udine",86,82,560,4,196,842,182,211,22,1494,1909
"030","Udine",87,50,473,6,213,742,139,186,22,1434,1781
"030","Udine",88,47,360,5,217,629,148,136,15,1357,1656
"030","Udine",89,28,264,5,167,464,122,103,9,1283,1517
"030","Udine",90,19,256,3,173,451,111,97,8,1109,1325
"030","Udine",91,16,177,2,150,345,100,64,8,927,1099
"030","Udine",92,12,88,2,75,177,42,18,7,497,564
"030","Udine",93,5,51,1,48,105,38,13,2,296,349
"030","Udine",94,7,36,0,35,78,36,8,3,279,326
"030","Udine",95,3,32,0,40,75,36,7,2,271,316
"030","Udine",96,0,28,0,34,62,38,4,0,249,291
"030","Udine",97,6,23,0,24,53,17,1,1,206,225
"030","Udine",98,5,9,0,27,41,21,4,2,130,157
"030","Udine",99,1,8,0,15,24,12,1,0,118,131
"030","Udine",100,3,9,0,26,38,21,2,1,147,171
"031","Gorizia",0,566,0,0,0,566,480,0,0,0,480
"031","Gorizia",1,533,0,0,0,533,578,0,0,0,578
"031","Gorizia",2,579,0,0,0,579,514,0,0,0,514
"031","Gorizia",3,613,0,0,0,613,550,0,0,0,550
"031","Gorizia",4,597,0,0,0,597,582,0,0,0,582
"031","Gorizia",5,583,0,0,0,583,586,0,0,0,586
"031","Gorizia",6,615,0,0,0,615,560,0,0,0,560
"031","Gorizia",7,590,0,0,0,590,551,0,0,0,551
"031","Gorizia",8,582,0,0,0,582,585,0,0,0,585
"031","Gorizia",9,619,0,0,0,619,531,0,0,0,531
"031","Gorizia",10,658,0,0,0,658,583,0,0,0,583
"031","Gorizia",11,626,0,0,0,626,579,0,0,0,579
"031","Gorizia",12,575,0,0,0,575,560,0,0,0,560
"031","Gorizia",13,625,0,0,0,625,509,0,0,0,509
"031","Gorizia",14,565,0,0,0,565,550,0,0,0,550
"031","Gorizia",15,593,0,0,0,593,531,0,0,0,531
"031","Gorizia",16,543,0,0,0,543,525,0,0,0,525
"031","Gorizia",17,573,0,0,0,573,531,0,0,0,531
"031","Gorizia",18,549,0,0,0,549,535,4,0,0,539
"031","Gorizia",19,572,0,0,0,572,546,11,0,0,557
"031","Gorizia",20,587,3,0,0,590,552,12,0,0,564
"031","Gorizia",21,598,4,0,0,602,493,37,0,0,530
"031","Gorizia",22,584,13,0,0,597,577,49,0,0,626
"031","Gorizia",23,538,17,0,0,555,495,53,0,0,548
"031","Gorizia",24,493,28,0,0,521,480,81,0,1,562
"031","Gorizia",25,516,50,1,0,567,409,118,0,0,527
"031","Gorizia",26,482,46,0,0,528,455,149,0,0,604
"031","Gorizia",27,529,74,1,0,604,388,183,3,0,574
"031","Gorizia",28,508,102,0,1,611,384,179,1,1,565
"031","Gorizia",29,529,152,0,0,681,389,229,4,1,623
"031","Gorizia",30,546,171,3,0,720,374,332,2,2,710
"031","Gorizia",31,521,208,3,0,732,322,326,9,0,657
"031","Gorizia",32,536,266,2,0,804,299,385,13,2,699
"031","Gorizia",33,558,315,1,0,874,365,449,11,3,828
"031","Gorizia",34,545,378,6,0,929,330,484,15,2,831
"031","Gorizia",35,548,378,3,0,929,323,563,19,3,908
"031","Gorizia",36,549,505,12,0,1066,325,596,24,3,948
"031","Gorizia",37,580,561,19,0,1160,356,681,26,5,1068
"031","Gorizia",38,522,573,21,2,1118,349,729,31,8,1117
"031","Gorizia",39,557,656,24,2,1239,292,766,47,5,1110
"031","Gorizia",40,493,638,38,1,1170,269,761,48,7,1085
"031","Gorizia",41,444,680,37,2,1163,282,748,74,16,1120
"031","Gorizia",42,399,771,51,4,1225,257,788,82,14,1141
"031","Gorizia",43,399,748,55,2,1204,230,787,70,11,1098
"031","Gorizia",44,388,774,58,2,1222,252,833,79,19,1183
"031","Gorizia",45,384,801,58,3,1246,207,826,85,30,1148
"031","Gorizia",46,337,830,73,3,1243,223,881,101,20,1225
"031","Gorizia",47,343,853,80,10,1286,192,876,101,24,1193
"031","Gorizia",48,271,851,74,5,1201,180,828,92,23,1123
"031","Gorizia",49,230,816,68,9,1123,159,756,96,33,1044
"031","Gorizia",50,225,788,80,5,1098,137,833,84,29,1083
"031","Gorizia",51,253,813,84,4,1154,128,705,96,29,958
"031","Gorizia",52,187,733,83,7,1010,104,736,88,37,965
"031","Gorizia",53,181,706,64,10,961,107,715,78,35,935
"031","Gorizia",54,144,675,74,4,897,100,727,67,46,940
"031","Gorizia",55,138,684,59,11,892,81,654,81,53,869
"031","Gorizia",56,134,712,74,8,928,88,636,73,69,866
"031","Gorizia",57,143,672,46,14,875,78,655,80,59,872
"031","Gorizia",58,116,658,61,16,851,76,733,67,72,948
"031","Gorizia",59,102,612,44,17,775,63,674,70,75,882
"031","Gorizia",60,105,704,50,18,877,54,673,66,87,880
"031","Gorizia",61,93,640,64,23,820,61,744,61,90,956
"031","Gorizia",62,77,717,67,25,886,40,751,53,134,978
"031","Gorizia",63,95,778,53,44,970,67,774,77,156,1074
"031","Gorizia",64,86,805,50,22,963,62,801,57,185,1105
"031","Gorizia",65,98,818,49,46,1011,65,764,46,197,1072
"031","Gorizia",66,53,565,24,27,669,35,501,38,150,724
"031","Gorizia",67,64,677,39,42,822,68,638,38,217,961
"031","Gorizia",68,66,666,39,48,819,55,597,49,204,905
"031","Gorizia",69,70,633,21,61,785,48,579,31,242,900
"031","Gorizia",70,83,687,25,61,856,62,629,25,253,969
"031","Gorizia",71,76,733,34,64,907,70,672,30,293,1065
"031","Gorizia",72,61,691,22,52,826,62,594,29,302,987
"031","Gorizia",73,64,627,27,73,791,66,546,25,325,962
"031","Gorizia",74,54,613,18,74,759,68,430,19,354,871
"031","Gorizia",75,47,532,10,58,647,46,390,20,391,847
"031","Gorizia",76,40,513,8,66,627,57,356,17,382,812
"031","Gorizia",77,45,419,6,53,523,58,309,20,436,823
"031","Gorizia",78,30,400,10,73,513,63,289,12,387,751
"031","Gorizia",79,43,388,5,77,513,64,280,12,411,767
"031","Gorizia",80,23,341,5,83,452,53,228,11,441,733
"031","Gorizia",81,26,351,6,75,458,75,208,9,490,782
"031","Gorizia",82,19,299,4,66,388,62,182,13,422,679
"031","Gorizia",83,28,261,0,71,360,54,145,5,448,652
"031","Gorizia",84,28,244,7,67,346,59,141,12,432,644
"031","Gorizia",85,12,151,2,54,219,61,111,12,406,590
"031","Gorizia",86,11,181,5,50,247,49,79,4,430,562
"031","Gorizia",87,13,131,0,66,210,62,60,12,388,522
"031","Gorizia",88,10,134,2,76,222,67,40,5,406,518
"031","Gorizia",89,10,71,1,50,132,47,31,5,383,466
"031","Gorizia",90,8,71,0,47,126,55,14,6,334,409
"031","Gorizia",91,8,59,1,48,116,31,15,2,259,307
"031","Gorizia",92,4,38,0,26,68,27,9,0,154,190
"031","Gorizia",93,1,9,0,13,23,9,5,0,66,80
"031","Gorizia",94,1,9,1,9,20,10,4,0,47,61
"031","Gorizia",95,0,2,0,5,7,2,1,1,49,53
"031","Gorizia",96,1,7,0,6,14,8,2,0,55,65
"031","Gorizia",97,1,7,0,3,11,8,0,0,63,71
"031","Gorizia",98,1,2,0,5,8,7,2,1,44,54
"031","Gorizia",99,0,1,1,2,4,4,0,0,33,37
"031","Gorizia",100,0,1,0,4,5,4,0,0,41,45
"032","Trieste",0,882,0,0,0,882,777,0,0,0,777
"032","Trieste",1,899,0,0,0,899,870,0,0,0,870
"032","Trieste",2,865,0,0,0,865,861,0,0,0,861
"032","Trieste",3,953,0,0,0,953,835,0,0,0,835
"032","Trieste",4,929,0,0,0,929,850,0,0,0,850
"032","Trieste",5,896,0,0,0,896,899,0,0,0,899
"032","Trieste",6,925,0,0,0,925,800,0,0,0,800
"032","Trieste",7,979,0,0,0,979,860,0,0,0,860
"032","Trieste",8,902,0,0,0,902,847,0,0,0,847
"032","Trieste",9,878,0,0,0,878,845,0,0,0,845
"032","Trieste",10,885,0,0,0,885,861,0,0,0,861
"032","Trieste",11,924,0,0,0,924,879,0,0,0,879
"032","Trieste",12,902,0,0,0,902,846,0,0,0,846
"032","Trieste",13,874,0,0,0,874,843,0,0,0,843
"032","Trieste",14,946,0,0,0,946,829,0,0,0,829
"032","Trieste",15,876,0,0,0,876,889,0,0,0,889
"032","Trieste",16,885,0,0,0,885,840,0,0,0,840
"032","Trieste",17,864,0,0,0,864,868,2,0,0,870
"032","Trieste",18,928,0,0,0,928,837,3,0,0,840
"032","Trieste",19,991,3,0,0,994,899,6,0,0,905
"032","Trieste",20,963,3,0,0,966,886,26,0,0,912
"032","Trieste",21,958,7,0,0,965,934,40,1,0,975
"032","Trieste",22,994,17,0,0,1011,814,55,0,0,869
"032","Trieste",23,974,22,0,0,996,853,85,1,0,939
"032","Trieste",24,942,45,0,0,987,803,115,0,1,919
"032","Trieste",25,930,52,1,0,983,755,146,3,1,905
"032","Trieste",26,890,73,0,0,963,781,193,3,0,977
"032","Trieste",27,859,96,3,0,958,726,244,5,0,975
"032","Trieste",28,888,160,2,0,1050,703,242,4,0,949
"032","Trieste",29,840,185,0,0,1025,686,329,3,0,1018
"032","Trieste",30,825,264,5,0,1094,618,385,12,2,1017
"032","Trieste",31,799,261,7,0,1067,632,443,16,2,1093
"032","Trieste",32,790,305,8,0,1103,601,507,14,3,1125
"032","Trieste",33,846,411,7,1,1265,617,592,23,6,1238
"032","Trieste",34,802,506,11,1,1320,629,699,27,4,1359
"032","Trieste",35,877,549,21,1,1448,651,821,49,6,1527
"032","Trieste",36,808,643,16,1,1468,632,857,70,2,1561
"032","Trieste",37,883,778,33,2,1696,632,980,72,16,1700
"032","Trieste",38,817,821,50,1,1689,624,1080,66,9,1779
"032","Trieste",39,894,939,40,5,1878,602,1120,104,17,1843
"032","Trieste",40,788,914,56,4,1762,565,1188,122,7,1882
"032","Trieste",41,735,977,82,5,1799,546,1123,127,18,1814
"032","Trieste",42,727,976,83,1,1787,460,1159,150,13,1782
"032","Trieste",43,644,1042,94,5,1785,406,1208,169,24,1807
"032","Trieste",44,645,991,94,8,1738,418,1243,201,17,1879
"032","Trieste",45,593,1143,118,4,1858,384,1347,189,30,1950
"032","Trieste",46,532,1218,144,3,1897,394,1386,227,23,2030
"032","Trieste",47,537,1247,147,9,1940,384,1332,219,44,1979
"032","Trieste",48,501,1257,163,9,1930,323,1260,191,47,1821
"032","Trieste",49,395,1149,183,6,1733,286,1247,197,50,1780
"032","Trieste",50,400,1249,149,11,1809,242,1195,214,47,1698
"032","Trieste",51,328,1159,153,14,1654,245,1126,244,50,1665
"032","Trieste",52,349,1124,144,12,1629,212,1166,221,69,1668
"032","Trieste",53,283,1072,140,23,1518,194,1168,219,72,1653
"032","Trieste",54,280,1051,153,18,1502,196,1149,205,85,1635
"032","Trieste",55,242,1138,176,23,1579,137,1154,201,95,1587
"032","Trieste",56,232,1083,150,26,1491,147,1150,204,112,1613
"032","Trieste",57,209,1062,129,25,1425,128,1098,185,121,1532
"032","Trieste",58,165,1030,131,20,1346,136,1121,150,128,1535
"032","Trieste",59,166,1088,127,25,1406,121,1151,151,133,1556
"032","Trieste",60,174,1104,118,36,1432,102,1134,152,180,1568
"032","Trieste",61,159,1121,115,44,1439,121,1248,185,216,1770
"032","Trieste",62,129,1206,150,53,1538,107,1180,173,205,1665
"032","Trieste",63,168,1318,126,57,1669,136,1280,188,256,1860
"032","Trieste",64,151,1291,134,64,1640,117,1353,169,296,1935
"032","Trieste",65,160,1377,104,65,1706,118,1308,168,312,1906
"032","Trieste",66,100,926,87,59,1172,76,900,123,245,1344
"032","Trieste",67,119,1104,87,56,1366,108,1069,127,366,1670
"032","Trieste",68,98,1162,73,79,1412,63,1098,120,365,1646
"032","Trieste",69,115,1141,95,83,1434,99,1010,127,411,1647
"032","Trieste",70,102,1183,73,103,1461,116,1114,123,462,1815
"032","Trieste",71,117,1250,87,126,1580,118,1136,128,576,1958
"032","Trieste",72,94,1202,76,144,1516,104,1032,114,572,1822
"032","Trieste",73,96,1173,60,132,1461,97,962,101,644,1804
"032","Trieste",74,79,1024,61,149,1313,90,858,86,634,1668
"032","Trieste",75,80,882,50,114,1126,117,715,69,655,1556
"032","Trieste",76,80,929,41,111,1161,114,697,61,686,1558
"032","Trieste",77,62,786,42,129,1019,99,595,56,677,1427
"032","Trieste",78,58,728,30,141,957,101,545,53,736,1435
"032","Trieste",79,43,674,32,139,888,85,466,57,736,1344
"032","Trieste",80,64,610,25,130,829,94,416,46,821,1377
"032","Trieste",81,53,658,32,154,897,97,394,44,843,1378
"032","Trieste",82,37,491,14,141,683,89,285,45,865,1284
"032","Trieste",83,34,450,14,117,615,86,270,30,695,1081
"032","Trieste",84,26,397,15,124,562,80,193,25,724,1022
"032","Trieste",85,27,342,8,115,492,85,200,16,863,1164
"032","Trieste",86,24,303,6,130,463,91,160,29,729,1009
"032","Trieste",87,13,246,7,122,388,86,102,35,720,943
"032","Trieste",88,19,248,7,132,406,76,88,31,660,855
"032","Trieste",89,17,180,6,105,308,67,71,19,716,873
"032","Trieste",90,17,136,6,115,274,51,59,25,652,787
"032","Trieste",91,13,113,2,75,203,56,34,11,624,725
"032","Trieste",92,3,57,0,50,110,38,10,11,328,387
"032","Trieste",93,2,21,2,16,41,10,7,5,154,176
"032","Trieste",94,1,13,1,17,32,11,3,3,141,158
"032","Trieste",95,0,13,1,23,37,5,1,3,82,91
"032","Trieste",96,2,12,1,19,34,16,2,3,109,130
"032","Trieste",97,2,13,0,13,28,11,1,4,121,137
"032","Trieste",98,1,5,0,10,16,11,4,1,78,94
"032","Trieste",99,0,5,0,10,15,9,1,0,75,85
"032","Trieste",100,0,2,0,18,20,10,1,0,105,116
"033","Piacenza",0,1200,0,0,0,1200,1147,0,0,0,1147
"033","Piacenza",1,1285,0,0,0,1285,1160,0,0,0,1160
"033","Piacenza",2,1327,0,0,0,1327,1287,0,0,0,1287
"033","Piacenza",3,1312,0,0,0,1312,1199,0,0,0,1199
"033","Piacenza",4,1291,0,0,0,1291,1188,0,0,0,1188
"033","Piacenza",5,1252,0,0,0,1252,1248,0,0,0,1248
"033","Piacenza",6,1234,0,0,0,1234,1230,0,0,0,1230
"033","Piacenza",7,1223,0,0,0,1223,1189,0,0,0,1189
"033","Piacenza",8,1232,0,0,0,1232,1190,0,0,0,1190
"033","Piacenza",9,1222,0,0,0,1222,1154,0,0,0,1154
"033","Piacenza",10,1198,0,0,0,1198,1131,0,0,0,1131
"033","Piacenza",11,1224,0,0,0,1224,1201,0,0,0,1201
"033","Piacenza",12,1200,0,0,0,1200,1110,0,0,0,1110
"033","Piacenza",13,1232,0,0,0,1232,1139,0,0,0,1139
"033","Piacenza",14,1262,0,0,0,1262,1149,0,0,0,1149
"033","Piacenza",15,1191,0,0,0,1191,1142,0,0,0,1142
"033","Piacenza",16,1172,0,0,0,1172,1109,1,0,0,1110
"033","Piacenza",17,1189,0,0,0,1189,1093,0,0,0,1093
"033","Piacenza",18,1237,0,0,0,1237,1132,9,0,0,1141
"033","Piacenza",19,1255,0,0,0,1255,1186,35,0,0,1221
"033","Piacenza",20,1330,7,0,0,1337,1158,67,0,0,1225
"033","Piacenza",21,1308,12,0,0,1320,1147,124,1,0,1272
"033","Piacenza",22,1297,21,0,0,1318,1101,184,0,0,1285
"033","Piacenza",23,1273,37,0,0,1310,1026,192,2,0,1220
"033","Piacenza",24,1230,77,1,0,1308,1041,288,2,1,1332
"033","Piacenza",25,1181,123,0,0,1304,959,344,4,1,1308
"033","Piacenza",26,1188,147,1,0,1336,928,466,4,0,1398
"033","Piacenza",27,1229,220,3,0,1452,881,515,10,1,1407
"033","Piacenza",28,1170,296,1,1,1468,853,552,9,1,1415
"033","Piacenza",29,1236,415,3,0,1654,788,649,8,0,1445
"033","Piacenza",30,1052,470,4,1,1527,734,821,13,3,1571
"033","Piacenza",31,1047,580,7,0,1634,724,858,23,2,1607
"033","Piacenza",32,1018,637,7,0,1662,691,940,24,4,1659
"033","Piacenza",33,1038,741,5,0,1784,751,1102,26,1,1880
"033","Piacenza",34,1035,790,14,1,1840,687,1135,33,8,1863
"033","Piacenza",35,1081,964,17,0,2062,686,1165,35,4,1890
"033","Piacenza",36,1031,1072,22,0,2125,711,1290,44,11,2056
"033","Piacenza",37,1049,1215,28,2,2294,685,1465,56,18,2224
"033","Piacenza",38,977,1185,33,3,2198,666,1525,68,12,2271
"033","Piacenza",39,860,1325,50,0,2235,582,1500,71,29,2182
"033","Piacenza",40,830,1405,55,1,2291,571,1583,91,20,2265
"033","Piacenza",41,810,1405,60,4,2279,529,1605,85,12,2231
"033","Piacenza",42,730,1511,82,6,2329,519,1648,105,23,2295
"033","Piacenza",43,722,1571,93,5,2391,480,1682,122,28,2312
"033","Piacenza",44,708,1628,74,4,2414,434,1592,122,45,2193
"033","Piacenza",45,636,1671,83,5,2395,421,1758,139,50,2368
"033","Piacenza",46,620,1615,109,6,2350,391,1752,125,55,2323
"033","Piacenza",47,561,1737,113,11,2422,395,1694,133,61,2283
"033","Piacenza",48,471,1656,86,10,2223,342,1725,134,57,2258
"033","Piacenza",49,448,1631,94,10,2183,341,1645,128,58,2172
"033","Piacenza",50,464,1643,96,12,2215,271,1674,127,64,2136
"033","Piacenza",51,364,1539,108,26,2037,265,1581,159,64,2069
"033","Piacenza",52,358,1527,105,12,2002,243,1548,129,83,2003
"033","Piacenza",53,334,1580,87,21,2022,209,1528,136,95,1968
"033","Piacenza",54,355,1474,99,17,1945,257,1478,112,90,1937
"033","Piacenza",55,293,1521,134,26,1974,210,1513,113,102,1938
"033","Piacenza",56,286,1411,95,26,1818,210,1514,98,122,1944
"033","Piacenza",57,254,1427,85,26,1792,192,1424,101,119,1836
"033","Piacenza",58,219,1335,66,26,1646,174,1294,84,145,1697
"033","Piacenza",59,230,1296,70,46,1642,151,1299,84,151,1685
"033","Piacenza",60,226,1305,71,31,1633,135,1209,83,178,1605
"033","Piacenza",61,236,1354,68,51,1709,137,1358,93,193,1781
"033","Piacenza",62,223,1361,79,42,1705,145,1330,66,239,1780
"033","Piacenza",63,226,1331,61,61,1679,135,1414,77,267,1893
"033","Piacenza",64,266,1426,61,69,1822,128,1377,83,287,1875
"033","Piacenza",65,242,1444,60,65,1811,123,1466,63,325,1977
"033","Piacenza",66,173,1063,49,45,1330,98,1079,50,298,1525
"033","Piacenza",67,192,1160,48,72,1472,114,1089,45,328,1576
"033","Piacenza",68,187,1192,44,68,1491,119,1065,57,389,1630
"033","Piacenza",69,218,1234,37,80,1569,120,1075,34,458,1687
"033","Piacenza",70,208,1220,34,96,1558,132,1096,44,485,1757
"033","Piacenza",71,219,1274,29,115,1637,148,1066,47,556,1817
"033","Piacenza",72,219,1213,34,111,1577,133,1044,42,626,1845
"033","Piacenza",73,193,1170,28,134,1525,103,978,41,728,1850
"033","Piacenza",74,200,1051,23,132,1406,112,838,31,662,1643
"033","Piacenza",75,176,930,17,133,1256,117,774,24,672,1587
"033","Piacenza",76,167,963,20,129,1279,112,720,17,766,1615
"033","Piacenza",77,164,862,18,140,1184,133,677,29,772,1611
"033","Piacenza",78,159,861,20,129,1169,98,620,11,780,1509
"033","Piacenza",79,169,749,13,146,1077,119,504,14,863,1500
"033","Piacenza",80,155,700,11,151,1017,137,490,15,891,1533
"033","Piacenza",81,146,683,12,154,995,154,423,19,958,1554
"033","Piacenza",82,123,607,6,154,890,132,304,15,896,1347
"033","Piacenza",83,124,493,5,133,755,133,270,14,888,1305
"033","Piacenza",84,87,456,8,158,709,127,244,4,935,1310
"033","Piacenza",85,100,364,5,135,604,126,208,8,852,1194
"033","Piacenza",86,66,330,4,117,517,123,143,6,823,1095
"033","Piacenza",87,64,271,2,124,461,95,118,13,800,1026
"033","Piacenza",88,47,226,1,113,387,96,75,7,711,889
"033","Piacenza",89,39,174,2,121,336,92,55,7,682,836
"033","Piacenza",90,32,136,0,93,261,64,42,3,560,669
"033","Piacenza",91,19,115,2,92,228,70,29,2,460,561
"033","Piacenza",92,13,53,0,43,109,38,12,1,251,302
"033","Piacenza",93,5,37,0,35,77,27,6,0,166,199
"033","Piacenza",94,10,23,0,25,58,34,6,1,152,193
"033","Piacenza",95,7,19,0,23,49,23,2,0,160,185
"033","Piacenza",96,7,18,0,24,49,16,1,0,166,183
"033","Piacenza",97,5,13,0,18,36,22,1,0,109,132
"033","Piacenza",98,2,5,1,9,17,11,1,0,95,107
"033","Piacenza",99,2,4,0,13,19,8,2,0,47,57
"033","Piacenza",100,3,2,1,12,18,12,1,0,78,91
"034","Parma",0,1945,0,0,0,1945,1920,0,0,0,1920
"034","Parma",1,2065,0,0,0,2065,1979,0,0,0,1979
"034","Parma",2,2096,0,0,0,2096,2001,0,0,0,2001
"034","Parma",3,2064,0,0,0,2064,1898,0,0,0,1898
"034","Parma",4,2086,0,0,0,2086,1921,0,0,0,1921
"034","Parma",5,1976,0,0,0,1976,1855,0,0,0,1855
"034","Parma",6,1994,0,0,0,1994,1857,0,0,0,1857
"034","Parma",7,1867,0,0,0,1867,1804,0,0,0,1804
"034","Parma",8,1883,0,0,0,1883,1707,0,0,0,1707
"034","Parma",9,1805,0,0,0,1805,1754,0,0,0,1754
"034","Parma",10,1840,0,0,0,1840,1747,0,0,0,1747
"034","Parma",11,1894,0,0,0,1894,1743,0,0,0,1743
"034","Parma",12,1747,0,0,0,1747,1815,0,0,0,1815
"034","Parma",13,1788,0,0,0,1788,1656,0,0,0,1656
"034","Parma",14,1885,0,0,0,1885,1720,0,0,0,1720
"034","Parma",15,1728,0,0,0,1728,1610,0,0,0,1610
"034","Parma",16,1807,0,0,0,1807,1647,0,0,0,1647
"034","Parma",17,1733,0,0,0,1733,1594,1,0,0,1595
"034","Parma",18,1780,1,0,0,1781,1659,6,0,0,1665
"034","Parma",19,1893,3,0,0,1896,1709,29,0,0,1738
"034","Parma",20,1948,6,0,0,1954,1738,58,0,0,1796
"034","Parma",21,1884,10,0,0,1894,1739,91,0,0,1830
"034","Parma",22,1859,24,0,0,1883,1681,165,0,0,1846
"034","Parma",23,1941,49,0,0,1990,1741,230,1,1,1973
"034","Parma",24,1804,79,0,0,1883,1672,316,6,0,1994
"034","Parma",25,1916,137,1,0,2054,1550,411,4,0,1965
"034","Parma",26,2013,185,1,0,2199,1571,527,6,0,2104
"034","Parma",27,1932,267,1,0,2200,1494,701,4,2,2201
"034","Parma",28,1920,383,4,0,2307,1546,837,10,2,2395
"034","Parma",29,1956,500,5,0,2461,1459,1005,15,3,2482
"034","Parma",30,1752,667,5,0,2424,1381,1093,12,3,2489
"034","Parma",31,1745,832,7,1,2585,1306,1295,16,5,2622
"034","Parma",32,1816,943,12,1,2772,1302,1402,30,5,2739
"034","Parma",33,1807,1070,10,0,2887,1335,1533,42,2,2912
"034","Parma",34,1705,1278,26,0,3009,1218,1747,74,8,3047
"034","Parma",35,1773,1444,31,2,3250,1205,1921,63,10,3199
"034","Parma",36,1655,1722,35,0,3412,1174,2096,74,17,3361
"034","Parma",37,1646,1832,38,3,3519,1141,2210,115,22,3488
"034","Parma",38,1547,1878,51,2,3478,1106,2216,134,15,3471
"034","Parma",39,1513,2028,73,3,3617,984,2422,126,18,3550
"034","Parma",40,1322,2037,104,4,3467,959,2375,191,26,3551
"034","Parma",41,1284,2207,79,6,3576,884,2388,173,34,3479
"034","Parma",42,1203,2324,97,6,3630,862,2584,187,29,3662
"034","Parma",43,1175,2333,141,5,3654,806,2493,222,38,3559
"034","Parma",44,1035,2386,150,10,3581,736,2630,206,51,3623
"034","Parma",45,984,2484,169,10,3647,751,2552,227,56,3586
"034","Parma",46,881,2555,146,14,3596,660,2578,229,57,3524
"034","Parma",47,846,2630,173,7,3656,594,2635,270,65,3564
"034","Parma",48,706,2439,179,18,3342,516,2568,232,67,3383
"034","Parma",49,584,2406,165,16,3171,528,2503,204,82,3317
"034","Parma",50,607,2344,176,17,3144,465,2331,231,87,3114
"034","Parma",51,506,2329,156,26,3017,464,2288,218,104,3074
"034","Parma",52,514,2187,157,20,2878,437,2310,192,101,3040
"034","Parma",53,416,2132,166,30,2744,380,2139,217,123,2859
"034","Parma",54,435,2096,150,24,2705,355,2184,188,129,2856
"034","Parma",55,394,2070,146,32,2642,325,2115,199,169,2808
"034","Parma",56,375,2023,133,38,2569,327,2035,188,152,2702
"034","Parma",57,306,2026,107,38,2477,292,2072,195,155,2714
"034","Parma",58,327,1955,123,41,2446,247,1936,166,182,2531
"034","Parma",59,289,1855,116,62,2322,214,1936,133,194,2477
"034","Parma",60,278,1841,107,56,2282,220,1925,139,233,2517
"034","Parma",61,262,2044,105,62,2473,233,2097,139,282,2751
"034","Parma",62,273,1969,114,63,2419,222,2033,122,298,2675
"034","Parma",63,273,2311,108,90,2782,201,2130,122,361,2814
"034","Parma",64,269,2216,104,100,2689,188,2084,137,381,2790
"034","Parma",65,269,2183,85,117,2654,188,2068,144,474,2874
"034","Parma",66,203,1578,70,75,1926,111,1585,84,389,2169
"034","Parma",67,224,1764,63,99,2150,161,1702,74,454,2391
"034","Parma",68,207,1706,65,107,2085,130,1602,77,499,2308
"034","Parma",69,250,1724,58,100,2132,160,1612,78,530,2380
"034","Parma",70,255,1714,70,134,2173,172,1626,72,633,2503
"034","Parma",71,250,1854,68,174,2346,166,1702,62,774,2704
"034","Parma",72,265,1786,45,177,2273,164,1603,70,802,2639
"034","Parma",73,219,1799,46,183,2247,178,1514,76,928,2696
"034","Parma",74,225,1596,45,203,2069,171,1235,58,857,2321
"034","Parma",75,203,1369,27,163,1762,126,1165,41,908,2240
"034","Parma",76,225,1429,18,185,1857,161,1162,33,1051,2407
"034","Parma",77,169,1309,22,179,1679,139,977,30,1072,2218
"034","Parma",78,176,1228,21,198,1623,146,819,30,1064,2059
"034","Parma",79,147,1073,14,188,1422,137,809,29,1124,2099
"034","Parma",80,151,1036,15,204,1406,149,663,23,1266,2101
"034","Parma",81,143,998,15,218,1374,136,626,33,1304,2099
"034","Parma",82,127,875,6,226,1234,156,492,22,1223,1893
"034","Parma",83,99,755,11,230,1095,129,407,20,1239,1795
"034","Parma",84,96,708,11,213,1028,160,389,17,1255,1821
"034","Parma",85,100,563,4,236,903,141,287,15,1219,1662
"034","Parma",86,75,500,10,236,821,149,275,10,1216,1650
"034","Parma",87,56,424,3,226,709,137,216,12,1135,1500
"034","Parma",88,53,348,7,214,622,107,150,16,1079,1352
"034","Parma",89,46,268,2,170,486,106,107,10,939,1162
"034","Parma",90,30,215,3,160,408,95,67,10,867,1039
"034","Parma",91,24,167,1,130,322,70,48,4,757,879
"034","Parma",92,10,84,0,83,177,37,20,3,402,462
"034","Parma",93,2,58,0,51,111,20,17,5,278,320
"034","Parma",94,5,30,0,32,67,37,11,0,213,261
"034","Parma",95,7,29,0,31,67,31,8,1,233,273
"034","Parma",96,6,23,0,35,64,33,4,2,232,271
"034","Parma",97,5,16,1,26,48,21,2,0,153,176
"034","Parma",98,7,15,0,22,44,11,1,0,129,141
"034","Parma",99,2,5,1,16,24,9,1,0,88,98
"034","Parma",100,2,9,0,15,26,11,0,1,122,134
"035","Reggio nell'Emilia",0,2695,0,0,0,2695,2733,0,0,0,2733
"035","Reggio nell'Emilia",1,2897,0,0,0,2897,2756,0,0,0,2756
"035","Reggio nell'Emilia",2,2920,0,0,0,2920,2712,0,0,0,2712
"035","Reggio nell'Emilia",3,2841,0,0,0,2841,2791,0,0,0,2791
"035","Reggio nell'Emilia",4,2930,0,0,0,2930,2665,0,0,0,2665
"035","Reggio nell'Emilia",5,2818,0,0,0,2818,2644,0,0,0,2644
"035","Reggio nell'Emilia",6,2770,0,0,0,2770,2625,0,0,0,2625
"035","Reggio nell'Emilia",7,2728,0,0,0,2728,2611,0,0,0,2611
"035","Reggio nell'Emilia",8,2709,0,0,0,2709,2464,0,0,0,2464
"035","Reggio nell'Emilia",9,2728,0,0,0,2728,2481,0,0,0,2481
"035","Reggio nell'Emilia",10,2596,0,0,0,2596,2386,0,0,0,2386
"035","Reggio nell'Emilia",11,2676,0,0,0,2676,2429,0,0,0,2429
"035","Reggio nell'Emilia",12,2512,0,0,0,2512,2353,0,0,0,2353
"035","Reggio nell'Emilia",13,2573,0,0,0,2573,2358,0,0,0,2358
"035","Reggio nell'Emilia",14,2358,0,0,0,2358,2297,0,0,0,2297
"035","Reggio nell'Emilia",15,2403,0,0,0,2403,2277,0,0,0,2277
"035","Reggio nell'Emilia",16,2267,0,0,0,2267,2204,0,0,0,2204
"035","Reggio nell'Emilia",17,2333,0,0,0,2333,2271,1,0,0,2272
"035","Reggio nell'Emilia",18,2436,0,0,0,2436,2217,8,0,0,2225
"035","Reggio nell'Emilia",19,2432,3,0,0,2435,2227,33,0,0,2260
"035","Reggio nell'Emilia",20,2388,2,0,0,2390,2160,90,0,0,2250
"035","Reggio nell'Emilia",21,2373,13,0,0,2386,2140,123,6,0,2269
"035","Reggio nell'Emilia",22,2376,22,0,1,2399,2051,232,1,0,2284
"035","Reggio nell'Emilia",23,2428,58,3,0,2489,1984,311,8,1,2304
"035","Reggio nell'Emilia",24,2288,114,4,0,2406,1840,472,13,1,2326
"035","Reggio nell'Emilia",25,2184,171,3,0,2358,1750,623,16,0,2389
"035","Reggio nell'Emilia",26,2304,304,6,0,2614,1719,837,21,0,2577
"035","Reggio nell'Emilia",27,2222,408,13,0,2643,1749,1091,27,0,2867
"035","Reggio nell'Emilia",28,2268,522,17,0,2807,1606,1230,23,17,2876
"035","Reggio nell'Emilia",29,2126,750,23,0,2899,1625,1382,29,20,3056
"035","Reggio nell'Emilia",30,2168,887,26,1,3082,1466,1603,38,18,3125
"035","Reggio nell'Emilia",31,2212,1110,24,0,3346,1466,1725,37,19,3247
"035","Reggio nell'Emilia",32,2100,1255,31,1,3387,1394,1965,54,17,3430
"035","Reggio nell'Emilia",33,2153,1554,48,0,3755,1461,2179,81,18,3739
"035","Reggio nell'Emilia",34,2152,1765,56,0,3973,1419,2373,77,28,3897
"035","Reggio nell'Emilia",35,2103,1976,49,26,4154,1486,2608,109,37,4240
"035","Reggio nell'Emilia",36,2037,2190,78,25,4330,1411,2699,139,29,4278
"035","Reggio nell'Emilia",37,2083,2438,107,29,4657,1386,2845,130,41,4402
"035","Reggio nell'Emilia",38,1865,2649,101,32,4647,1313,2839,195,37,4384
"035","Reggio nell'Emilia",39,1817,2706,120,33,4676,1185,3006,225,48,4464
"035","Reggio nell'Emilia",40,1659,2815,144,24,4642,1127,2913,195,55,4290
"035","Reggio nell'Emilia",41,1491,2785,147,30,4453,1010,3040,233,59,4342
"035","Reggio nell'Emilia",42,1367,2883,172,31,4453,986,3084,258,56,4384
"035","Reggio nell'Emilia",43,1253,3054,185,28,4520,909,3048,257,67,4281
"035","Reggio nell'Emilia",44,1204,2901,194,23,4322,858,2951,289,74,4172
"035","Reggio nell'Emilia",45,1115,3094,204,29,4442,827,3140,276,85,4328
"035","Reggio nell'Emilia",46,1016,3085,220,29,4350,740,3066,279,86,4171
"035","Reggio nell'Emilia",47,939,3119,217,31,4306,664,3157,320,87,4228
"035","Reggio nell'Emilia",48,847,2889,235,29,4000,627,2855,301,92,3875
"035","Reggio nell'Emilia",49,746,2787,235,39,3807,590,2913,295,119,3917
"035","Reggio nell'Emilia",50,634,2758,219,29,3640,549,2779,255,125,3708
"035","Reggio nell'Emilia",51,623,2749,227,35,3634,456,2850,323,125,3754
"035","Reggio nell'Emilia",52,547,2659,199,32,3437,489,2603,303,147,3542
"035","Reggio nell'Emilia",53,486,2554,201,39,3280,441,2486,270,135,3332
"035","Reggio nell'Emilia",54,469,2607,191,35,3302,356,2574,250,188,3368
"035","Reggio nell'Emilia",55,396,2570,206,53,3225,355,2437,255,193,3240
"035","Reggio nell'Emilia",56,406,2470,183,42,3101,341,2417,222,207,3187
"035","Reggio nell'Emilia",57,342,2420,167,59,2988,286,2487,224,228,3225
"035","Reggio nell'Emilia",58,321,2312,165,43,2841,279,2308,205,230,3022
"035","Reggio nell'Emilia",59,308,2188,136,71,2703,274,2268,159,244,2945
"035","Reggio nell'Emilia",60,281,2278,120,66,2745,227,2303,167,253,2950
"035","Reggio nell'Emilia",61,277,2374,132,60,2843,230,2453,197,323,3203
"035","Reggio nell'Emilia",62,272,2450,140,79,2941,216,2377,175,330,3098
"035","Reggio nell'Emilia",63,310,2582,140,88,3120,232,2502,153,456,3343
"035","Reggio nell'Emilia",64,272,2506,127,92,2997,230,2383,162,449,3224
"035","Reggio nell'Emilia",65,230,2534,100,111,2975,178,2416,154,501,3249
"035","Reggio nell'Emilia",66,176,1731,89,92,2088,136,1631,99,411,2277
"035","Reggio nell'Emilia",67,186,1989,73,119,2367,124,1771,101,505,2501
"035","Reggio nell'Emilia",68,201,1966,73,112,2352,125,1744,90,552,2511
"035","Reggio nell'Emilia",69,220,1875,71,113,2279,139,1758,72,590,2559
"035","Reggio nell'Emilia",70,225,1903,73,148,2349,154,1756,75,601,2586
"035","Reggio nell'Emilia",71,225,2018,56,156,2455,155,1807,68,780,2810
"035","Reggio nell'Emilia",72,219,1922,48,173,2362,152,1713,68,835,2768
"035","Reggio nell'Emilia",73,226,1975,48,195,2444,141,1557,60,892,2650
"035","Reggio nell'Emilia",74,198,1674,41,207,2120,145,1428,57,923,2553
"035","Reggio nell'Emilia",75,163,1486,35,160,1844,121,1244,36,924,2325
"035","Reggio nell'Emilia",76,223,1662,33,210,2128,138,1207,41,1098,2484
"035","Reggio nell'Emilia",77,206,1489,33,221,1949,132,1112,29,1180,2453
"035","Reggio nell'Emilia",78,177,1367,11,195,1750,126,931,34,1109,2200
"035","Reggio nell'Emilia",79,155,1200,16,219,1590,120,796,27,1121,2064
"035","Reggio nell'Emilia",80,167,1139,20,258,1584,132,715,20,1206,2073
"035","Reggio nell'Emilia",81,138,1060,19,225,1442,123,660,22,1384,2189
"035","Reggio nell'Emilia",82,124,976,8,249,1357,144,566,16,1328,2054
"035","Reggio nell'Emilia",83,111,817,10,228,1166,134,490,13,1354,1991
"035","Reggio nell'Emilia",84,92,723,9,259,1083,124,378,20,1383,1905
"035","Reggio nell'Emilia",85,93,605,10,202,910,99,312,15,1223,1649
"035","Reggio nell'Emilia",86,74,532,4,237,847,134,291,9,1324,1758
"035","Reggio nell'Emilia",87,60,471,7,233,771,115,195,8,1208,1526
"035","Reggio nell'Emilia",88,53,379,3,183,618,104,167,13,1194,1478
"035","Reggio nell'Emilia",89,34,305,2,190,531,94,89,9,976,1168
"035","Reggio nell'Emilia",90,28,224,0,189,441,75,62,11,899,1047
"035","Reggio nell'Emilia",91,31,165,3,130,329,58,40,1,734,833
"035","Reggio nell'Emilia",92,16,87,1,75,179,38,28,3,451,520
"035","Reggio nell'Emilia",93,11,39,0,41,91,33,11,4,260,308
"035","Reggio nell'Emilia",94,6,29,1,43,79,22,5,0,219,246
"035","Reggio nell'Emilia",95,6,36,0,36,78,16,7,2,257,282
"035","Reggio nell'Emilia",96,2,28,0,37,67,19,7,0,217,243
"035","Reggio nell'Emilia",97,4,24,0,23,51,21,1,0,169,191
"035","Reggio nell'Emilia",98,5,6,0,22,33,7,0,0,130,137
"035","Reggio nell'Emilia",99,3,7,0,14,24,7,0,0,89,96
"035","Reggio nell'Emilia",100,1,6,0,16,23,15,0,0,126,141
"036","Modena",0,3494,0,0,0,3494,3251,0,0,0,3251
"036","Modena",1,3570,0,0,0,3570,3380,0,0,0,3380
"036","Modena",2,3605,0,0,0,3605,3405,0,0,0,3405
"036","Modena",3,3697,0,0,0,3697,3419,0,0,0,3419
"036","Modena",4,3527,0,0,0,3527,3347,0,0,0,3347
"036","Modena",5,3470,0,0,0,3470,3296,0,0,0,3296
"036","Modena",6,3365,0,0,0,3365,3288,0,0,0,3288
"036","Modena",7,3374,0,0,0,3374,3194,0,0,0,3194
"036","Modena",8,3235,0,0,0,3235,3113,0,0,0,3113
"036","Modena",9,3289,0,0,0,3289,3074,0,0,0,3074
"036","Modena",10,3257,0,0,0,3257,3171,0,0,0,3171
"036","Modena",11,3338,0,0,0,3338,3147,0,0,0,3147
"036","Modena",12,3058,0,0,0,3058,2994,0,0,0,2994
"036","Modena",13,3146,0,0,0,3146,2884,0,0,0,2884
"036","Modena",14,3146,0,0,0,3146,2945,0,0,0,2945
"036","Modena",15,3067,0,0,0,3067,2876,0,0,0,2876
"036","Modena",16,3064,0,0,0,3064,2816,0,0,0,2816
"036","Modena",17,3101,0,0,0,3101,2801,0,0,0,2801
"036","Modena",18,3155,0,0,0,3155,2876,11,0,0,2887
"036","Modena",19,3205,1,0,1,3207,2849,47,0,0,2896
"036","Modena",20,3220,8,0,0,3228,2885,101,2,0,2988
"036","Modena",21,3275,28,0,0,3303,2896,207,1,0,3104
"036","Modena",22,3066,38,0,0,3104,2820,284,0,0,3104
"036","Modena",23,3059,91,0,0,3150,2605,417,2,1,3025
"036","Modena",24,3001,135,1,2,3139,2584,572,3,1,3160
"036","Modena",25,2966,199,2,2,3169,2391,774,1,3,3169
"036","Modena",26,2984,313,2,1,3300,2438,935,4,4,3381
"036","Modena",27,2983,481,2,0,3466,2328,1231,12,2,3573
"036","Modena",28,2996,711,5,1,3713,2146,1457,6,3,3612
"036","Modena",29,2997,882,7,2,3888,2117,1565,19,5,3706
"036","Modena",30,2838,1096,13,2,3949,2080,1912,19,5,4016
"036","Modena",31,2746,1357,15,3,4121,1917,2184,50,10,4161
"036","Modena",32,2653,1612,19,1,4285,1925,2417,56,8,4406
"036","Modena",33,2734,1903,27,2,4666,1891,2699,65,8,4663
"036","Modena",34,2661,2187,31,4,4883,1928,2874,95,12,4909
"036","Modena",35,2655,2356,44,6,5061,1949,3163,119,21,5252
"036","Modena",36,2698,2824,62,3,5587,1853,3414,153,24,5444
"036","Modena",37,2827,3021,75,6,5929,1793,3560,211,30,5594
"036","Modena",38,2536,3265,108,10,5919,1732,3797,236,22,5787
"036","Modena",39,2320,3346,144,5,5815,1578,3880,259,29,5746
"036","Modena",40,2193,3594,155,9,5951,1561,3914,284,39,5798
"036","Modena",41,1924,3636,192,14,5766,1381,3841,295,48,5565
"036","Modena",42,1886,3763,220,11,5880,1330,4077,302,40,5749
"036","Modena",43,1731,3849,228,11,5819,1172,3919,345,69,5505
"036","Modena",44,1599,3934,268,16,5817,1128,4023,367,72,5590
"036","Modena",45,1519,3915,272,15,5721,1103,4076,389,85,5653
"036","Modena",46,1338,4060,283,21,5702,1013,4106,378,103,5600
"036","Modena",47,1230,4099,301,23,5653,905,4186,404,113,5608
"036","Modena",48,1093,3952,290,35,5370,839,4140,391,79,5449
"036","Modena",49,1004,3773,290,31,5098,818,3965,379,111,5273
"036","Modena",50,932,3859,300,27,5118,784,3923,421,156,5284
"036","Modena",51,836,3753,272,34,4895,661,3790,374,162,4987
"036","Modena",52,717,3655,288,42,4702,685,3690,375,179,4929
"036","Modena",53,627,3507,241,28,4403,580,3454,349,207,4590
"036","Modena",54,641,3509,262,43,4455,570,3583,331,234,4718
"036","Modena",55,587,3534,260,47,4428,495,3677,354,236,4762
"036","Modena",56,553,3431,243,65,4292,477,3354,304,224,4359
"036","Modena",57,468,3369,224,57,4118,437,3415,300,298,4450
"036","Modena",58,423,3150,192,72,3837,382,3257,300,282,4221
"036","Modena",59,383,3082,205,70,3740,366,3276,251,331,4224
"036","Modena",60,397,3097,172,85,3751,309,3185,220,357,4071
"036","Modena",61,357,3222,194,92,3865,289,3389,248,421,4347
"036","Modena",62,341,3457,207,129,4134,308,3414,245,524,4491
"036","Modena",63,381,3594,181,119,4275,281,3422,257,533,4493
"036","Modena",64,311,3559,171,146,4187,268,3449,241,566,4524
"036","Modena",65,318,3638,150,156,4262,257,3428,188,671,4544
"036","Modena",66,215,2471,102,146,2934,158,2448,128,558,3292
"036","Modena",67,236,2779,106,129,3250,187,2630,126,689,3632
"036","Modena",68,248,2790,98,165,3301,222,2600,137,715,3674
"036","Modena",69,261,2657,94,174,3186,199,2389,106,819,3513
"036","Modena",70,255,2743,82,198,3278,173,2402,120,896,3591
"036","Modena",71,278,2822,84,220,3404,218,2601,115,969,3903
"036","Modena",72,261,2657,88,247,3253,195,2425,88,1152,3860
"036","Modena",73,281,2717,66,246,3310,199,2316,84,1283,3882
"036","Modena",74,239,2385,50,259,2933,173,1961,80,1297,3511
"036","Modena",75,211,2197,52,241,2701,166,1818,72,1303,3359
"036","Modena",76,220,2280,35,293,2828,171,1704,64,1462,3401
"036","Modena",77,234,2186,39,317,2776,186,1611,56,1634,3487
"036","Modena",78,190,1901,22,310,2423,181,1387,55,1558,3181
"036","Modena",79,189,1712,25,317,2243,162,1132,39,1639,2972
"036","Modena",80,184,1587,11,334,2116,147,1049,48,1746,2990
"036","Modena",81,153,1526,21,352,2052,176,955,47,1802,2980
"036","Modena",82,133,1341,11,337,1822,156,772,22,1731,2681
"036","Modena",83,120,1168,14,308,1610,153,653,21,1887,2714
"036","Modena",84,119,1070,9,306,1504,142,553,18,1866,2579
"036","Modena",85,114,861,14,314,1303,155,438,23,1725,2341
"036","Modena",86,100,703,3,334,1140,162,398,20,1779,2359
"036","Modena",87,94,603,6,327,1030,136,297,14,1563,2010
"036","Modena",88,48,520,0,265,833,152,204,16,1540,1912
"036","Modena",89,46,407,2,241,696,117,151,9,1376,1653
"036","Modena",90,26,325,4,256,611,98,111,8,1236,1453
"036","Modena",91,34,260,1,230,525,93,82,9,1068,1252
"036","Modena",92,18,129,1,142,290,41,28,3,589,661
"036","Modena",93,7,57,2,68,134,27,20,2,355,404
"036","Modena",94,10,43,0,46,99,22,13,3,300,338
"036","Modena",95,7,37,0,63,107,28,5,1,325,359
"036","Modena",96,9,26,0,63,98,25,3,1,303,332
"036","Modena",97,6,15,0,55,76,24,4,0,240,268
"036","Modena",98,2,4,0,25,31,16,2,1,161,180
"036","Modena",99,1,6,0,17,24,10,2,1,105,118
"036","Modena",100,2,7,0,32,41,17,0,0,154,171
"037","Bologna",0,4308,0,0,0,4308,4151,0,0,0,4151
"037","Bologna",1,4526,0,0,0,4526,4193,0,0,0,4193
"037","Bologna",2,4647,0,0,0,4647,4503,0,0,0,4503
"037","Bologna",3,4547,0,0,0,4547,4301,0,0,0,4301
"037","Bologna",4,4600,0,0,0,4600,4386,0,0,0,4386
"037","Bologna",5,4622,0,0,0,4622,4252,0,0,0,4252
"037","Bologna",6,4420,0,0,0,4420,4170,0,0,0,4170
"037","Bologna",7,4450,0,0,0,4450,4173,0,0,0,4173
"037","Bologna",8,4236,0,0,0,4236,4026,0,0,0,4026
"037","Bologna",9,4345,0,0,0,4345,4025,0,0,0,4025
"037","Bologna",10,4289,0,0,0,4289,4039,0,0,0,4039
"037","Bologna",11,4306,0,0,0,4306,4084,0,0,0,4084
"037","Bologna",12,4051,0,0,0,4051,4010,0,0,0,4010
"037","Bologna",13,4044,0,0,0,4044,3745,0,0,0,3745
"037","Bologna",14,3985,0,0,0,3985,3695,0,0,0,3695
"037","Bologna",15,3826,0,0,0,3826,3678,0,0,0,3678
"037","Bologna",16,3835,1,0,0,3836,3494,0,0,0,3494
"037","Bologna",17,3804,0,0,0,3804,3602,1,0,0,3603
"037","Bologna",18,3864,1,0,0,3865,3431,9,0,0,3440
"037","Bologna",19,3793,2,0,0,3795,3661,38,0,0,3699
"037","Bologna",20,3847,10,0,0,3857,3458,90,0,0,3548
"037","Bologna",21,3876,16,0,1,3893,3512,179,1,0,3692
"037","Bologna",22,3798,36,0,0,3834,3491,293,0,0,3784
"037","Bologna",23,3838,60,1,0,3899,3460,413,7,1,3881
"037","Bologna",24,3817,135,1,0,3953,3324,597,3,1,3925
"037","Bologna",25,3642,220,3,0,3865,3496,763,8,0,4267
"037","Bologna",26,4102,309,2,0,4413,3463,934,9,0,4406
"037","Bologna",27,4067,468,5,0,4540,3455,1231,18,3,4707
"037","Bologna",28,4194,673,3,0,4870,3624,1545,18,1,5188
"037","Bologna",29,4226,883,5,0,5114,3613,1784,32,7,5436
"037","Bologna",30,4113,1256,11,0,5380,3415,2071,32,7,5525
"037","Bologna",31,4270,1493,20,1,5784,3338,2447,53,9,5847
"037","Bologna",32,4138,1782,15,1,5936,3416,2855,66,9,6346
"037","Bologna",33,4233,2273,26,3,6535,3412,3092,80,16,6600
"037","Bologna",34,4223,2428,27,5,6683,3388,3295,109,14,6806
"037","Bologna",35,4292,2873,44,2,7211,3345,3613,154,23,7135
"037","Bologna",36,4263,3108,87,8,7466,3507,4027,205,31,7770
"037","Bologna",37,4263,3472,97,8,7840,3439,4358,206,35,8038
"037","Bologna",38,4161,3830,136,4,8131,3342,4590,261,34,8227
"037","Bologna",39,3941,3992,179,8,8120,3176,4673,304,49,8202
"037","Bologna",40,3799,4454,183,12,8448,3101,4951,365,27,8444
"037","Bologna",41,3468,4483,211,12,8174,2837,5069,366,51,8323
"037","Bologna",42,3363,4726,266,10,8365,2707,5159,428,77,8371
"037","Bologna",43,3111,4650,276,23,8060,2565,5145,443,92,8245
"037","Bologna",44,2883,4849,335,21,8088,2423,5268,495,95,8281
"037","Bologna",45,2750,4998,357,25,8130,2299,5277,538,90,8204
"037","Bologna",46,2512,5116,399,32,8059,2114,5482,527,143,8266
"037","Bologna",47,2498,5400,408,37,8343,2105,5614,642,136,8497
"037","Bologna",48,2123,5142,399,27,7691,1855,5115,589,136,7695
"037","Bologna",49,1857,5015,436,42,7350,1647,5210,614,150,7621
"037","Bologna",50,1717,4892,387,45,7041,1576,5127,576,171,7450
"037","Bologna",51,1543,4827,414,53,6837,1457,4940,637,175,7209
"037","Bologna",52,1413,4928,468,68,6877,1451,4886,574,217,7128
"037","Bologna",53,1295,4719,454,66,6534,1294,4869,624,232,7019
"037","Bologna",54,1166,4834,452,55,6507,1179,4771,593,268,6811
"037","Bologna",55,1042,4714,438,72,6266,1091,4741,555,294,6681
"037","Bologna",56,978,4516,393,80,5967,1077,4563,558,320,6518
"037","Bologna",57,908,4561,350,89,5908,922,4617,543,355,6437
"037","Bologna",58,793,4413,345,102,5653,797,4384,511,402,6094
"037","Bologna",59,738,4293,383,100,5514,774,4444,494,418,6130
"037","Bologna",60,663,4222,364,124,5373,705,4330,475,482,5992
"037","Bologna",61,659,4489,333,139,5620,667,4576,453,517,6213
"037","Bologna",62,568,4692,318,158,5736,639,4625,455,644,6363
"037","Bologna",63,595,4959,315,197,6066,582,5058,473,796,6909
"037","Bologna",64,572,5197,329,205,6303,513,5127,420,876,6936
"037","Bologna",65,550,5383,307,265,6505,512,5164,439,1034,7149
"037","Bologna",66,364,3548,187,215,4314,356,3470,279,775,4880
"037","Bologna",67,422,4094,197,228,4941,381,3913,308,935,5537
"037","Bologna",68,380,4075,204,253,4912,373,3859,291,1083,5606
"037","Bologna",69,351,3990,179,261,4781,414,3782,269,1183,5648
"037","Bologna",70,448,4042,182,319,4991,402,3802,265,1350,5819
"037","Bologna",71,442,4398,167,378,5385,412,4131,255,1603,6401
"037","Bologna",72,445,4384,152,429,5410,399,3868,225,1864,6356
"037","Bologna",73,360,4160,143,409,5072,386,3741,203,1930,6260
"037","Bologna",74,359,3796,128,423,4706,336,3289,180,1837,5642
"037","Bologna",75,287,3482,97,439,4305,331,2889,145,1931,5296
"037","Bologna",76,311,3434,70,487,4302,317,2814,143,2298,5572
"037","Bologna",77,320,3228,87,503,4138,301,2557,128,2372,5358
"037","Bologna",78,281,3023,89,490,3883,344,2279,103,2409,5135
"037","Bologna",79,273,2782,63,513,3631,280,1997,95,2461,4833
"037","Bologna",80,229,2608,46,557,3440,360,1792,101,2670,4923
"037","Bologna",81,253,2524,46,573,3396,343,1659,94,2902,4998
"037","Bologna",82,182,2217,35,541,2975,319,1398,60,2774,4551
"037","Bologna",83,175,1896,37,558,2666,326,1094,61,2863,4344
"037","Bologna",84,176,1759,25,583,2543,289,991,53,2841,4174
"037","Bologna",85,140,1469,15,535,2159,292,789,56,2740,3877
"037","Bologna",86,132,1296,10,539,1977,278,663,63,2674,3678
"037","Bologna",87,98,1068,16,475,1657,259,542,54,2494,3349
"037","Bologna",88,92,875,4,479,1450,222,363,33,2379,2997
"037","Bologna",89,71,689,9,453,1222,235,275,24,2199,2733
"037","Bologna",90,54,555,8,390,1007,181,170,33,1984,2368
"037","Bologna",91,48,406,5,343,802,156,150,14,1707,2027
"037","Bologna",92,18,224,2,179,423,90,45,14,1010,1159
"037","Bologna",93,7,93,0,112,212,65,26,9,615,715
"037","Bologna",94,7,76,1,103,187,57,18,9,513,597
"037","Bologna",95,13,66,0,103,182,43,15,4,528,590
"037","Bologna",96,7,62,1,98,168,50,12,6,491,559
"037","Bologna",97,8,39,0,74,121,33,7,2,433,475
"037","Bologna",98,3,29,1,60,93,32,1,1,261,295
"037","Bologna",99,4,13,0,35,52,24,3,1,175,203
"037","Bologna",100,2,6,0,36,44,40,4,0,283,327
"038","Ferrara",0,1332,0,0,0,1332,1306,0,0,0,1306
"038","Ferrara",1,1359,0,0,0,1359,1347,0,0,0,1347
"038","Ferrara",2,1442,0,0,0,1442,1404,0,0,0,1404
"038","Ferrara",3,1426,0,0,0,1426,1377,0,0,0,1377
"038","Ferrara",4,1399,0,0,0,1399,1301,0,0,0,1301
"038","Ferrara",5,1424,0,0,0,1424,1266,0,0,0,1266
"038","Ferrara",6,1410,0,0,0,1410,1285,0,0,0,1285
"038","Ferrara",7,1359,0,0,0,1359,1283,0,0,0,1283
"038","Ferrara",8,1271,0,0,0,1271,1286,0,0,0,1286
"038","Ferrara",9,1264,0,0,0,1264,1303,0,0,0,1303
"038","Ferrara",10,1267,0,0,0,1267,1255,0,0,0,1255
"038","Ferrara",11,1259,0,0,0,1259,1215,0,0,0,1215
"038","Ferrara",12,1256,0,0,0,1256,1150,0,0,0,1150
"038","Ferrara",13,1343,0,0,0,1343,1158,0,0,0,1158
"038","Ferrara",14,1269,0,0,0,1269,1143,0,0,0,1143
"038","Ferrara",15,1240,0,0,0,1240,1144,0,0,0,1144
"038","Ferrara",16,1222,0,0,0,1222,1154,0,0,0,1154
"038","Ferrara",17,1259,0,0,0,1259,1167,0,0,0,1167
"038","Ferrara",18,1237,0,0,0,1237,1184,1,0,0,1185
"038","Ferrara",19,1332,0,0,0,1332,1169,17,0,0,1186
"038","Ferrara",20,1355,0,0,0,1355,1247,27,1,0,1275
"038","Ferrara",21,1368,8,0,0,1376,1212,66,0,0,1278
"038","Ferrara",22,1333,9,0,0,1342,1220,96,0,0,1316
"038","Ferrara",23,1277,27,1,0,1305,1196,134,0,0,1330
"038","Ferrara",24,1272,39,0,0,1311,1164,160,1,1,1326
"038","Ferrara",25,1353,61,0,0,1414,1202,227,1,1,1431
"038","Ferrara",26,1412,106,3,0,1521,1213,318,3,0,1534
"038","Ferrara",27,1397,149,0,0,1546,1125,421,3,2,1551
"038","Ferrara",28,1470,235,1,0,1706,1191,508,2,2,1703
"038","Ferrara",29,1335,317,3,0,1655,1118,596,10,1,1725
"038","Ferrara",30,1351,379,6,0,1736,1133,656,9,3,1801
"038","Ferrara",31,1372,437,3,0,1812,1128,773,17,2,1920
"038","Ferrara",32,1483,541,8,0,2032,1159,859,22,6,2046
"038","Ferrara",33,1569,659,7,1,2236,1192,1011,32,7,2242
"038","Ferrara",34,1564,801,8,0,2373,1177,1113,52,8,2350
"038","Ferrara",35,1553,935,29,1,2518,1157,1258,61,7,2483
"038","Ferrara",36,1573,1000,34,5,2612,1171,1359,75,7,2612
"038","Ferrara",37,1567,1238,46,0,2851,1188,1515,105,7,2815
"038","Ferrara",38,1531,1249,56,2,2838,1047,1549,113,6,2715
"038","Ferrara",39,1459,1363,64,0,2886,1048,1634,155,16,2853
"038","Ferrara",40,1325,1435,93,5,2858,999,1628,128,25,2780
"038","Ferrara",41,1222,1491,97,5,2815,900,1729,162,25,2816
"038","Ferrara",42,1253,1616,105,2,2976,867,1821,195,32,2915
"038","Ferrara",43,1098,1656,121,7,2882,746,1924,183,27,2880
"038","Ferrara",44,971,1717,146,8,2842,680,1871,198,47,2796
"038","Ferrara",45,970,1839,141,9,2959,641,1907,208,49,2805
"038","Ferrara",46,892,1823,174,20,2909,574,2043,234,52,2903
"038","Ferrara",47,797,1883,192,10,2882,605,2067,241,66,2979
"038","Ferrara",48,717,1928,205,13,2863,559,2086,207,58,2910
"038","Ferrara",49,637,1879,184,19,2719,481,2033,234,75,2823
"038","Ferrara",50,548,1858,184,23,2613,402,2114,210,86,2812
"038","Ferrara",51,501,1960,188,22,2671,341,2072,255,91,2759
"038","Ferrara",52,472,1948,181,18,2619,410,2047,226,110,2793
"038","Ferrara",53,408,1890,165,24,2487,335,1932,196,129,2592
"038","Ferrara",54,406,1891,193,25,2515,332,2072,220,129,2753
"038","Ferrara",55,336,1915,166,30,2447,291,2075,226,142,2734
"038","Ferrara",56,297,1883,162,32,2374,264,1945,192,139,2540
"038","Ferrara",57,275,1803,150,37,2265,255,1986,179,174,2594
"038","Ferrara",58,246,1863,126,48,2283,218,1913,188,180,2499
"038","Ferrara",59,227,1814,114,56,2211,183,1962,157,226,2528
"038","Ferrara",60,228,1844,106,55,2233,184,1846,150,242,2422
"038","Ferrara",61,203,1965,137,63,2368,172,1993,139,259,2563
"038","Ferrara",62,182,1922,109,74,2287,154,1969,133,320,2576
"038","Ferrara",63,187,2049,130,81,2447,164,2109,140,347,2760
"038","Ferrara",64,205,2206,99,90,2600,155,2126,124,423,2828
"038","Ferrara",65,197,2206,100,111,2614,143,2184,109,500,2936
"038","Ferrara",66,101,1406,65,95,1667,95,1335,73,323,1826
"038","Ferrara",67,150,1735,66,100,2051,118,1605,76,451,2250
"038","Ferrara",68,135,1665,52,109,1961,124,1548,68,492,2232
"038","Ferrara",69,138,1624,68,126,1956,132,1519,56,500,2207
"038","Ferrara",70,149,1620,50,127,1946,112,1457,69,601,2239
"038","Ferrara",71,157,1775,50,152,2134,133,1631,75,767,2606
"038","Ferrara",72,141,1730,38,164,2073,132,1476,62,790,2460
"038","Ferrara",73,120,1702,30,161,2013,120,1469,59,862,2510
"038","Ferrara",74,128,1523,29,181,1861,114,1293,46,909,2362
"038","Ferrara",75,138,1323,34,177,1672,96,1135,58,879,2168
"038","Ferrara",76,106,1407,35,223,1771,123,1102,35,1016,2276
"038","Ferrara",77,102,1381,20,207,1710,108,1028,35,1068,2239
"038","Ferrara",78,75,1262,11,230,1578,108,889,32,1168,2197
"038","Ferrara",79,79,1107,21,193,1400,94,770,29,1174,2067
"038","Ferrara",80,86,1008,15,236,1345,90,686,32,1281,2089
"038","Ferrara",81,73,1017,12,255,1357,100,596,15,1279,1990
"038","Ferrara",82,66,754,6,225,1051,102,475,17,1168,1762
"038","Ferrara",83,44,739,5,211,999,100,370,13,1169,1652
"038","Ferrara",84,42,580,6,210,838,107,338,15,1131,1591
"038","Ferrara",85,37,514,3,217,771,92,281,18,1105,1496
"038","Ferrara",86,25,426,3,247,701,96,229,8,1103,1436
"038","Ferrara",87,34,361,2,183,580,86,160,19,990,1255
"038","Ferrara",88,24,329,2,189,544,84,132,7,962,1185
"038","Ferrara",89,12,231,2,186,431,56,76,6,873,1011
"038","Ferrara",90,9,186,4,167,366,53,63,3,745,864
"038","Ferrara",91,16,124,2,142,284,57,44,4,619,724
"038","Ferrara",92,7,60,0,77,144,40,21,2,329,392
"038","Ferrara",93,2,36,0,33,71,14,7,2,189,212
"038","Ferrara",94,4,24,1,33,62,21,5,0,158,184
"038","Ferrara",95,0,15,0,19,34,16,4,2,195,217
"038","Ferrara",96,2,20,0,31,53,12,5,1,152,170
"038","Ferrara",97,1,9,0,19,29,12,2,1,143,158
"038","Ferrara",98,0,5,1,17,23,7,2,1,93,103
"038","Ferrara",99,0,4,0,13,17,5,0,0,65,70
"038","Ferrara",100,2,3,0,15,20,5,0,0,87,92
"039","Ravenna",0,1719,0,0,0,1719,1602,0,0,0,1602
"039","Ravenna",1,1787,0,0,0,1787,1710,0,0,0,1710
"039","Ravenna",2,1887,0,0,0,1887,1727,0,0,0,1727
"039","Ravenna",3,1814,0,0,0,1814,1804,0,0,0,1804
"039","Ravenna",4,1804,0,0,0,1804,1693,0,0,0,1693
"039","Ravenna",5,1814,0,0,0,1814,1755,0,0,0,1755
"039","Ravenna",6,1721,0,0,0,1721,1622,0,0,0,1622
"039","Ravenna",7,1696,0,0,0,1696,1594,0,0,0,1594
"039","Ravenna",8,1762,0,0,0,1762,1550,0,0,0,1550
"039","Ravenna",9,1644,0,0,0,1644,1622,0,0,0,1622
"039","Ravenna",10,1665,0,0,0,1665,1601,0,0,0,1601
"039","Ravenna",11,1675,0,0,0,1675,1522,0,0,0,1522
"039","Ravenna",12,1604,0,0,0,1604,1465,0,0,0,1465
"039","Ravenna",13,1547,0,0,0,1547,1449,0,0,0,1449
"039","Ravenna",14,1557,0,0,0,1557,1490,0,0,0,1490
"039","Ravenna",15,1549,0,0,0,1549,1439,0,0,0,1439
"039","Ravenna",16,1516,0,0,0,1516,1405,0,0,0,1405
"039","Ravenna",17,1531,0,0,0,1531,1425,0,0,0,1425
"039","Ravenna",18,1460,0,0,0,1460,1399,10,0,0,1409
"039","Ravenna",19,1535,0,0,0,1535,1438,17,0,0,1455
"039","Ravenna",20,1576,2,0,0,1578,1477,60,0,0,1537
"039","Ravenna",21,1611,11,0,0,1622,1410,89,1,0,1500
"039","Ravenna",22,1516,26,0,0,1542,1392,133,0,0,1525
"039","Ravenna",23,1529,38,0,0,1567,1336,198,1,1,1536
"039","Ravenna",24,1481,73,0,0,1554,1311,283,1,1,1596
"039","Ravenna",25,1563,105,1,0,1669,1372,323,4,0,1699
"039","Ravenna",26,1488,149,1,0,1638,1286,445,3,1,1735
"039","Ravenna",27,1540,201,4,0,1745,1240,520,11,2,1773
"039","Ravenna",28,1508,291,1,0,1800,1334,577,11,2,1924
"039","Ravenna",29,1579,403,5,0,1987,1259,817,14,2,2092
"039","Ravenna",30,1451,506,5,0,1962,1171,915,22,1,2109
"039","Ravenna",31,1512,641,7,0,2160,1166,951,25,5,2147
"039","Ravenna",32,1606,695,9,2,2312,1223,1120,27,2,2372
"039","Ravenna",33,1580,866,16,2,2464,1261,1203,38,5,2507
"039","Ravenna",34,1578,1025,13,0,2616,1309,1465,52,5,2831
"039","Ravenna",35,1657,1130,26,2,2815,1236,1434,66,9,2745
"039","Ravenna",36,1671,1326,33,2,3032,1259,1600,93,7,2959
"039","Ravenna",37,1669,1392,42,1,3104,1252,1696,117,11,3076
"039","Ravenna",38,1528,1469,68,2,3067,1190,1806,116,17,3129
"039","Ravenna",39,1524,1652,71,1,3248,1151,1840,156,23,3170
"039","Ravenna",40,1411,1688,89,3,3191,1034,1921,145,21,3121
"039","Ravenna",41,1351,1695,87,9,3142,1099,1955,173,33,3260
"039","Ravenna",42,1265,1779,123,6,3173,934,2072,205,31,3242
"039","Ravenna",43,1225,1939,127,10,3301,905,2020,190,36,3151
"039","Ravenna",44,1154,2017,158,8,3337,876,2011,231,39,3157
"039","Ravenna",45,1045,2038,144,15,3242,855,2107,232,50,3244
"039","Ravenna",46,981,1997,192,7,3177,729,2114,254,71,3168
"039","Ravenna",47,991,2190,188,20,3389,721,2238,272,62,3293
"039","Ravenna",48,841,2030,201,16,3088,625,2058,253,64,3000
"039","Ravenna",49,678,2035,204,15,2932,589,2055,248,70,2962
"039","Ravenna",50,725,1998,209,26,2958,549,2060,261,82,2952
"039","Ravenna",51,605,2027,207,21,2860,523,2009,252,77,2861
"039","Ravenna",52,555,1956,191,24,2726,473,1996,240,95,2804
"039","Ravenna",53,477,1919,172,25,2593,446,1904,236,90,2676
"039","Ravenna",54,433,1838,204,28,2503,391,1959,239,118,2707
"039","Ravenna",55,427,1934,199,40,2600,381,1930,232,132,2675
"039","Ravenna",56,331,1867,179,29,2406,316,1886,211,123,2536
"039","Ravenna",57,315,1735,153,46,2249,307,1836,190,125,2458
"039","Ravenna",58,267,1751,173,35,2226,271,1716,187,138,2312
"039","Ravenna",59,289,1743,138,43,2213,259,1805,189,176,2429
"039","Ravenna",60,249,1773,144,46,2212,261,1722,168,198,2349
"039","Ravenna",61,255,1818,153,53,2279,230,1877,191,226,2524
"039","Ravenna",62,219,1859,145,63,2286,221,1958,155,255,2589
"039","Ravenna",63,227,2008,142,65,2442,221,2047,167,304,2739
"039","Ravenna",64,214,2018,136,79,2447,170,1871,141,357,2539
"039","Ravenna",65,202,2009,112,99,2422,177,2046,129,375,2727
"039","Ravenna",66,123,1421,87,73,1704,135,1403,106,313,1957
"039","Ravenna",67,164,1620,84,97,1965,125,1552,102,395,2174
"039","Ravenna",68,143,1535,72,85,1835,136,1481,90,442,2149
"039","Ravenna",69,165,1547,66,101,1879,132,1434,85,427,2078
"039","Ravenna",70,165,1562,69,106,1902,135,1436,92,438,2101
"039","Ravenna",71,181,1685,66,138,2070,149,1641,81,611,2482
"039","Ravenna",72,181,1731,58,145,2115,169,1613,71,696,2549
"039","Ravenna",73,181,1723,74,159,2137,146,1510,69,738,2463
"039","Ravenna",74,163,1559,48,184,1954,134,1321,62,771,2288
"039","Ravenna",75,120,1380,34,160,1694,134,1205,50,785,2174
"039","Ravenna",76,158,1494,36,172,1860,100,1159,55,931,2245
"039","Ravenna",77,152,1407,30,196,1785,132,1100,46,1014,2292
"039","Ravenna",78,138,1278,22,196,1634,134,949,49,948,2080
"039","Ravenna",79,120,1136,14,181,1451,132,809,30,979,1950
"039","Ravenna",80,95,1084,14,204,1397,133,703,26,1041,1903
"039","Ravenna",81,111,1035,16,213,1375,166,642,31,1139,1978
"039","Ravenna",82,109,940,19,199,1267,121,529,22,1085,1757
"039","Ravenna",83,95,810,14,239,1158,123,467,24,1129,1743
"039","Ravenna",84,85,752,8,202,1047,102,385,16,1072,1575
"039","Ravenna",85,71,599,7,212,889,114,300,20,1083,1517
"039","Ravenna",86,75,601,5,198,879,108,265,15,1061,1449
"039","Ravenna",87,37,417,7,177,638,91,209,12,1015,1327
"039","Ravenna",88,37,379,2,194,612,91,163,10,960,1224
"039","Ravenna",89,37,296,4,180,517,78,113,12,843,1046
"039","Ravenna",90,20,252,3,143,418,69,82,8,815,974
"039","Ravenna",91,17,165,3,143,328,54,56,11,644,765
"039","Ravenna",92,16,106,2,69,193,35,25,2,419,481
"039","Ravenna",93,5,51,0,50,106,19,12,1,256,288
"039","Ravenna",94,8,40,0,37,85,20,11,1,210,242
"039","Ravenna",95,5,32,0,44,81,25,3,0,213,241
"039","Ravenna",96,8,30,0,34,72,14,5,1,217,237
"039","Ravenna",97,3,19,0,31,53,18,1,0,160,179
"039","Ravenna",98,2,10,0,29,41,7,1,1,110,119
"039","Ravenna",99,1,9,0,23,33,9,0,1,82,92
"039","Ravenna",100,0,8,0,32,40,19,0,1,136,156
"040","Forl√¨-Cesena",0,1889,0,0,0,1889,1687,0,0,0,1687
"040","Forl√¨-Cesena",1,1944,0,0,0,1944,1749,0,0,0,1749
"040","Forl√¨-Cesena",2,1944,0,0,0,1944,1753,0,0,0,1753
"040","Forl√¨-Cesena",3,1913,0,0,0,1913,1811,0,0,0,1811
"040","Forl√¨-Cesena",4,1911,0,0,0,1911,1830,0,0,0,1830
"040","Forl√¨-Cesena",5,1861,0,0,0,1861,1862,0,0,0,1862
"040","Forl√¨-Cesena",6,1835,0,0,0,1835,1746,0,0,0,1746
"040","Forl√¨-Cesena",7,1847,0,0,0,1847,1749,0,0,0,1749
"040","Forl√¨-Cesena",8,1813,0,0,0,1813,1698,0,0,0,1698
"040","Forl√¨-Cesena",9,1758,0,0,0,1758,1688,0,0,0,1688
"040","Forl√¨-Cesena",10,1766,0,0,0,1766,1619,0,0,0,1619
"040","Forl√¨-Cesena",11,1805,0,0,0,1805,1606,0,0,0,1606
"040","Forl√¨-Cesena",12,1651,0,0,0,1651,1535,0,0,0,1535
"040","Forl√¨-Cesena",13,1695,0,0,0,1695,1594,0,0,0,1594
"040","Forl√¨-Cesena",14,1663,0,0,0,1663,1520,0,0,0,1520
"040","Forl√¨-Cesena",15,1657,0,0,0,1657,1564,0,0,0,1564
"040","Forl√¨-Cesena",16,1592,0,0,0,1592,1522,0,0,0,1522
"040","Forl√¨-Cesena",17,1662,0,0,0,1662,1527,1,0,0,1528
"040","Forl√¨-Cesena",18,1669,0,0,0,1669,1430,3,0,0,1433
"040","Forl√¨-Cesena",19,1656,0,0,0,1656,1582,23,0,0,1605
"040","Forl√¨-Cesena",20,1772,4,0,0,1776,1586,66,0,0,1652
"040","Forl√¨-Cesena",21,1753,11,0,0,1764,1616,103,0,0,1719
"040","Forl√¨-Cesena",22,1772,17,0,0,1789,1591,147,0,0,1738
"040","Forl√¨-Cesena",23,1786,46,0,0,1832,1469,200,2,0,1671
"040","Forl√¨-Cesena",24,1780,74,0,0,1854,1533,318,4,0,1855
"040","Forl√¨-Cesena",25,1761,112,0,0,1873,1452,351,5,0,1808
"040","Forl√¨-Cesena",26,1809,134,0,0,1943,1604,467,1,0,2072
"040","Forl√¨-Cesena",27,1711,232,2,0,1945,1472,525,4,0,2001
"040","Forl√¨-Cesena",28,1747,291,0,1,2039,1371,650,8,2,2031
"040","Forl√¨-Cesena",29,1797,431,1,0,2229,1405,787,15,1,2208
"040","Forl√¨-Cesena",30,1815,557,1,0,2373,1379,954,12,3,2348
"040","Forl√¨-Cesena",31,1637,645,6,0,2288,1331,1055,17,1,2404
"040","Forl√¨-Cesena",32,1739,817,8,1,2565,1360,1128,21,7,2516
"040","Forl√¨-Cesena",33,1718,939,9,2,2668,1398,1319,25,6,2748
"040","Forl√¨-Cesena",34,1772,1116,15,2,2905,1278,1478,37,8,2801
"040","Forl√¨-Cesena",35,1692,1249,23,2,2966,1243,1583,51,8,2885
"040","Forl√¨-Cesena",36,1722,1401,29,4,3156,1258,1750,67,8,3083
"040","Forl√¨-Cesena",37,1744,1610,39,4,3397,1306,1922,80,12,3320
"040","Forl√¨-Cesena",38,1563,1647,57,4,3271,1132,1943,97,14,3186
"040","Forl√¨-Cesena",39,1431,1771,56,2,3260,1068,1991,113,20,3192
"040","Forl√¨-Cesena",40,1368,1813,65,8,3254,997,2066,140,22,3225
"040","Forl√¨-Cesena",41,1271,1903,93,4,3271,885,2099,148,22,3154
"040","Forl√¨-Cesena",42,1225,1926,87,5,3243,882,2172,164,25,3243
"040","Forl√¨-Cesena",43,1096,2061,90,8,3255,838,2182,174,41,3235
"040","Forl√¨-Cesena",44,1030,2060,121,9,3220,792,2093,168,39,3092
"040","Forl√¨-Cesena",45,952,2191,135,6,3284,697,2212,179,48,3136
"040","Forl√¨-Cesena",46,841,2216,128,15,3200,684,2271,185,58,3198
"040","Forl√¨-Cesena",47,847,2230,148,12,3237,682,2262,186,60,3190
"040","Forl√¨-Cesena",48,687,2191,151,16,3045,594,2199,181,79,3053
"040","Forl√¨-Cesena",49,657,2144,128,24,2953,552,2141,178,62,2933
"040","Forl√¨-Cesena",50,576,2116,160,22,2874,499,2124,174,97,2894
"040","Forl√¨-Cesena",51,507,2069,133,21,2730,497,2104,205,91,2897
"040","Forl√¨-Cesena",52,504,2025,156,26,2711,463,2077,206,84,2830
"040","Forl√¨-Cesena",53,431,1927,123,20,2501,417,2016,179,109,2721
"040","Forl√¨-Cesena",54,400,1968,130,31,2529,435,1956,192,110,2693
"040","Forl√¨-Cesena",55,375,2011,138,21,2545,393,1948,168,141,2650
"040","Forl√¨-Cesena",56,336,1900,126,27,2389,357,1931,160,146,2594
"040","Forl√¨-Cesena",57,300,1801,110,28,2239,317,1800,140,155,2412
"040","Forl√¨-Cesena",58,279,1807,110,33,2229,303,1828,151,160,2442
"040","Forl√¨-Cesena",59,290,1754,95,43,2182,281,1926,125,179,2511
"040","Forl√¨-Cesena",60,217,1838,94,55,2204,263,1849,129,213,2454
"040","Forl√¨-Cesena",61,247,1863,105,47,2262,236,1908,112,241,2497
"040","Forl√¨-Cesena",62,239,1970,97,67,2373,218,1882,120,243,2463
"040","Forl√¨-Cesena",63,214,1972,90,75,2351,182,2017,117,287,2603
"040","Forl√¨-Cesena",64,211,2004,97,85,2397,208,1856,104,321,2489
"040","Forl√¨-Cesena",65,210,2011,90,96,2407,177,1915,93,363,2548
"040","Forl√¨-Cesena",66,175,1585,78,70,1908,143,1530,71,290,2034
"040","Forl√¨-Cesena",67,171,1652,55,78,1956,133,1618,76,358,2185
"040","Forl√¨-Cesena",68,191,1629,58,88,1966,142,1492,79,423,2136
"040","Forl√¨-Cesena",69,181,1578,55,97,1911,124,1476,76,440,2116
"040","Forl√¨-Cesena",70,213,1624,47,103,1987,142,1485,52,501,2180
"040","Forl√¨-Cesena",71,181,1660,51,131,2023,169,1539,65,584,2357
"040","Forl√¨-Cesena",72,185,1634,37,125,1981,132,1486,74,674,2366
"040","Forl√¨-Cesena",73,214,1698,32,184,2128,147,1439,63,770,2419
"040","Forl√¨-Cesena",74,180,1521,23,175,1899,156,1234,38,769,2197
"040","Forl√¨-Cesena",75,148,1307,25,141,1621,128,1082,37,709,1956
"040","Forl√¨-Cesena",76,149,1392,25,176,1742,108,1034,37,902,2081
"040","Forl√¨-Cesena",77,130,1283,30,165,1608,118,904,28,942,1992
"040","Forl√¨-Cesena",78,133,1199,23,171,1526,114,813,22,968,1917
"040","Forl√¨-Cesena",79,96,1047,11,176,1330,99,713,21,875,1708
"040","Forl√¨-Cesena",80,103,892,13,186,1194,101,653,22,972,1748
"040","Forl√¨-Cesena",81,105,944,10,187,1246,116,596,25,1062,1799
"040","Forl√¨-Cesena",82,89,803,12,182,1086,111,482,19,1063,1675
"040","Forl√¨-Cesena",83,87,787,7,191,1072,118,461,19,1081,1679
"040","Forl√¨-Cesena",84,61,686,3,202,952,102,357,13,1082,1554
"040","Forl√¨-Cesena",85,53,565,6,171,795,93,268,12,1012,1385
"040","Forl√¨-Cesena",86,63,510,4,183,760,102,261,8,968,1339
"040","Forl√¨-Cesena",87,57,391,4,171,623,94,171,7,921,1193
"040","Forl√¨-Cesena",88,35,351,2,186,574,78,138,13,894,1123
"040","Forl√¨-Cesena",89,22,266,5,155,448,75,82,6,792,955
"040","Forl√¨-Cesena",90,23,209,2,145,379,74,76,6,732,888
"040","Forl√¨-Cesena",91,24,139,0,121,284,38,43,3,576,660
"040","Forl√¨-Cesena",92,5,64,0,61,130,44,21,1,336,402
"040","Forl√¨-Cesena",93,5,34,1,44,84,15,6,0,225,246
"040","Forl√¨-Cesena",94,3,29,1,33,66,19,1,2,178,200
"040","Forl√¨-Cesena",95,2,20,0,42,64,20,3,1,195,219
"040","Forl√¨-Cesena",96,4,19,0,32,55,10,0,3,171,184
"040","Forl√¨-Cesena",97,3,10,0,32,45,15,3,1,142,161
"040","Forl√¨-Cesena",98,2,4,0,19,25,13,1,0,101,115
"040","Forl√¨-Cesena",99,0,3,0,15,18,3,0,0,64,67
"040","Forl√¨-Cesena",100,0,3,0,18,21,9,0,0,122,131
"041","Pesaro e Urbino",0,1734,0,0,0,1734,1685,0,0,0,1685
"041","Pesaro e Urbino",1,1735,0,0,0,1735,1616,0,0,0,1616
"041","Pesaro e Urbino",2,1713,0,0,0,1713,1705,0,0,0,1705
"041","Pesaro e Urbino",3,1785,0,0,0,1785,1708,0,0,0,1708
"041","Pesaro e Urbino",4,1764,0,0,0,1764,1598,0,0,0,1598
"041","Pesaro e Urbino",5,1785,0,0,0,1785,1631,0,0,0,1631
"041","Pesaro e Urbino",6,1771,0,0,0,1771,1663,0,0,0,1663
"041","Pesaro e Urbino",7,1717,0,0,0,1717,1602,0,0,0,1602
"041","Pesaro e Urbino",8,1652,0,0,0,1652,1663,0,0,0,1663
"041","Pesaro e Urbino",9,1674,0,0,0,1674,1622,0,0,0,1622
"041","Pesaro e Urbino",10,1671,0,0,0,1671,1614,0,0,0,1614
"041","Pesaro e Urbino",11,1784,0,0,0,1784,1587,0,0,0,1587
"041","Pesaro e Urbino",12,1655,0,0,0,1655,1541,0,0,0,1541
"041","Pesaro e Urbino",13,1643,0,0,0,1643,1538,0,0,0,1538
"041","Pesaro e Urbino",14,1633,0,0,0,1633,1544,0,0,0,1544
"041","Pesaro e Urbino",15,1645,0,0,0,1645,1543,0,0,0,1543
"041","Pesaro e Urbino",16,1661,0,0,0,1661,1566,0,0,0,1566
"041","Pesaro e Urbino",17,1655,0,0,0,1655,1503,2,0,0,1505
"041","Pesaro e Urbino",18,1592,1,0,0,1593,1530,3,0,0,1533
"041","Pesaro e Urbino",19,1753,0,0,0,1753,1628,26,0,0,1654
"041","Pesaro e Urbino",20,1799,4,0,0,1803,1580,62,0,0,1642
"041","Pesaro e Urbino",21,1703,9,1,0,1713,1652,78,0,0,1730
"041","Pesaro e Urbino",22,1761,24,0,0,1785,1626,139,0,0,1765
"041","Pesaro e Urbino",23,1782,48,0,0,1830,1589,182,0,1,1772
"041","Pesaro e Urbino",24,1817,58,1,0,1876,1468,235,1,0,1704
"041","Pesaro e Urbino",25,1731,101,0,0,1832,1486,352,3,0,1841
"041","Pesaro e Urbino",26,1721,141,2,0,1864,1440,392,1,1,1834
"041","Pesaro e Urbino",27,1684,203,2,0,1889,1376,529,6,3,1914
"041","Pesaro e Urbino",28,1793,307,3,0,2103,1338,666,9,2,2015
"041","Pesaro e Urbino",29,1634,435,2,0,2071,1315,809,9,1,2134
"041","Pesaro e Urbino",30,1630,514,3,0,2147,1200,946,16,2,2164
"041","Pesaro e Urbino",31,1522,613,10,1,2146,1118,1076,21,3,2218
"041","Pesaro e Urbino",32,1524,728,7,1,2260,1027,1218,34,4,2283
"041","Pesaro e Urbino",33,1586,962,18,0,2566,1046,1429,38,8,2521
"041","Pesaro e Urbino",34,1462,1067,13,0,2542,1006,1561,54,11,2632
"041","Pesaro e Urbino",35,1434,1314,15,1,2764,939,1707,58,8,2712
"041","Pesaro e Urbino",36,1361,1366,27,1,2755,907,1799,72,10,2788
"041","Pesaro e Urbino",37,1291,1610,37,3,2941,887,1888,79,6,2860
"041","Pesaro e Urbino",38,1220,1632,56,2,2910,823,1953,86,20,2882
"041","Pesaro e Urbino",39,1109,1739,60,1,2909,687,1979,124,14,2804
"041","Pesaro e Urbino",40,1073,1832,78,6,2989,704,2104,132,19,2959
"041","Pesaro e Urbino",41,962,1880,92,4,2938,566,2080,132,23,2801
"041","Pesaro e Urbino",42,941,1950,94,3,2988,661,2201,151,22,3035
"041","Pesaro e Urbino",43,787,2101,89,6,2983,586,2164,135,32,2917
"041","Pesaro e Urbino",44,809,2133,95,8,3045,523,2174,182,52,2931
"041","Pesaro e Urbino",45,739,2118,116,5,2978,444,2333,146,46,2969
"041","Pesaro e Urbino",46,627,2210,120,13,2970,456,2227,151,44,2878
"041","Pesaro e Urbino",47,613,2281,141,12,3047,437,2313,168,46,2964
"041","Pesaro e Urbino",48,555,2227,143,12,2937,375,2199,144,53,2771
"041","Pesaro e Urbino",49,433,2172,101,10,2716,353,2124,154,61,2692
"041","Pesaro e Urbino",50,438,2120,133,12,2703,359,2165,152,63,2739
"041","Pesaro e Urbino",51,458,2035,108,21,2622,307,2119,148,100,2674
"041","Pesaro e Urbino",52,378,1980,133,20,2511,326,2051,144,82,2603
"041","Pesaro e Urbino",53,343,1954,110,16,2423,274,1981,136,92,2483
"041","Pesaro e Urbino",54,352,1905,96,19,2372,242,1904,118,107,2371
"041","Pesaro e Urbino",55,282,1869,89,21,2261,247,1897,119,135,2398
"041","Pesaro e Urbino",56,273,1770,80,29,2152,207,1792,116,143,2258
"041","Pesaro e Urbino",57,257,1721,90,23,2091,192,1778,109,142,2221
"041","Pesaro e Urbino",58,226,1711,84,34,2055,200,1753,95,137,2185
"041","Pesaro e Urbino",59,219,1670,84,39,2012,186,1695,96,150,2127
"041","Pesaro e Urbino",60,189,1784,67,35,2075,160,1740,82,200,2182
"041","Pesaro e Urbino",61,220,1819,73,44,2156,178,1888,87,210,2363
"041","Pesaro e Urbino",62,215,1793,72,50,2130,139,1852,81,251,2323
"041","Pesaro e Urbino",63,194,1855,71,67,2187,142,1860,80,272,2354
"041","Pesaro e Urbino",64,207,1813,62,57,2139,122,1715,67,302,2206
"041","Pesaro e Urbino",65,210,1876,66,72,2224,133,1840,85,345,2403
"041","Pesaro e Urbino",66,158,1475,52,68,1753,111,1405,68,293,1877
"041","Pesaro e Urbino",67,155,1545,38,74,1812,88,1439,55,399,1981
"041","Pesaro e Urbino",68,152,1541,36,64,1793,101,1438,41,390,1970
"041","Pesaro e Urbino",69,174,1476,30,85,1765,95,1246,47,392,1780
"041","Pesaro e Urbino",70,146,1394,36,86,1662,99,1258,45,470,1872
"041","Pesaro e Urbino",71,142,1527,38,84,1791,121,1362,42,579,2104
"041","Pesaro e Urbino",72,158,1603,27,99,1887,106,1271,35,603,2015
"041","Pesaro e Urbino",73,193,1510,31,131,1865,101,1310,35,721,2167
"041","Pesaro e Urbino",74,128,1292,28,125,1573,98,1085,22,693,1898
"041","Pesaro e Urbino",75,120,1270,21,114,1525,95,945,25,716,1781
"041","Pesaro e Urbino",76,125,1140,18,157,1440,111,972,27,804,1914
"041","Pesaro e Urbino",77,116,1196,15,151,1478,85,897,20,849,1851
"041","Pesaro e Urbino",78,107,1064,8,167,1346,89,778,24,893,1784
"041","Pesaro e Urbino",79,91,956,9,148,1204,111,635,13,881,1640
"041","Pesaro e Urbino",80,83,978,4,171,1236,88,647,17,1009,1761
"041","Pesaro e Urbino",81,66,915,8,163,1152,90,538,11,1040,1679
"041","Pesaro e Urbino",82,63,735,5,166,969,97,422,10,900,1429
"041","Pesaro e Urbino",83,70,685,4,171,930,70,343,6,1047,1466
"041","Pesaro e Urbino",84,52,676,3,170,901,72,326,9,1056,1463
"041","Pesaro e Urbino",85,49,526,1,162,738,76,253,7,986,1322
"041","Pesaro e Urbino",86,39,482,6,170,697,76,205,8,967,1256
"041","Pesaro e Urbino",87,33,350,2,159,544,66,152,8,903,1129
"041","Pesaro e Urbino",88,32,315,3,155,505,68,119,5,798,990
"041","Pesaro e Urbino",89,21,257,4,136,418,50,100,3,674,827
"041","Pesaro e Urbino",90,20,187,2,140,349,46,70,7,699,822
"041","Pesaro e Urbino",91,9,174,1,104,288,37,40,2,658,737
"041","Pesaro e Urbino",92,8,62,0,74,144,13,21,0,348,382
"041","Pesaro e Urbino",93,5,30,0,38,73,15,0,1,174,190
"041","Pesaro e Urbino",94,1,24,0,25,50,9,3,0,152,164
"041","Pesaro e Urbino",95,1,30,0,28,59,8,5,1,151,165
"041","Pesaro e Urbino",96,1,17,0,34,52,10,5,2,188,205
"041","Pesaro e Urbino",97,2,9,0,21,32,9,2,0,126,137
"041","Pesaro e Urbino",98,3,9,0,12,24,2,0,0,93,95
"041","Pesaro e Urbino",99,0,5,0,11,16,2,1,0,72,75
"041","Pesaro e Urbino",100,2,4,0,12,18,6,2,0,78,86
"042","Ancona",0,2106,0,0,0,2106,2079,0,0,0,2079
"042","Ancona",1,2212,0,0,0,2212,2138,0,0,0,2138
"042","Ancona",2,2356,0,0,0,2356,2170,0,0,0,2170
"042","Ancona",3,2305,0,0,0,2305,2287,0,0,0,2287
"042","Ancona",4,2215,0,0,0,2215,2154,0,0,0,2154
"042","Ancona",5,2176,0,0,0,2176,2096,0,0,0,2096
"042","Ancona",6,2151,0,0,0,2151,2051,0,0,0,2051
"042","Ancona",7,2192,0,0,0,2192,2061,0,0,0,2061
"042","Ancona",8,2110,0,0,0,2110,2021,0,0,0,2021
"042","Ancona",9,2241,0,0,0,2241,2051,0,0,0,2051
"042","Ancona",10,2125,0,0,0,2125,2001,0,0,0,2001
"042","Ancona",11,2135,0,0,0,2135,1997,0,0,0,1997
"042","Ancona",12,2110,0,0,0,2110,2034,0,0,0,2034
"042","Ancona",13,2204,0,0,0,2204,2011,0,0,0,2011
"042","Ancona",14,2130,0,0,0,2130,2049,0,0,0,2049
"042","Ancona",15,2077,0,0,0,2077,1947,0,0,0,1947
"042","Ancona",16,2119,0,0,0,2119,1943,0,0,0,1943
"042","Ancona",17,2052,0,0,0,2052,1973,1,0,0,1974
"042","Ancona",18,2155,0,0,0,2155,2042,8,0,0,2050
"042","Ancona",19,2226,1,0,0,2227,2099,30,1,0,2130
"042","Ancona",20,2273,2,0,0,2275,2030,36,0,0,2066
"042","Ancona",21,2360,15,0,0,2375,2084,88,0,0,2172
"042","Ancona",22,2144,25,0,0,2169,2003,162,1,0,2166
"042","Ancona",23,2130,57,1,0,2188,1960,235,1,1,2197
"042","Ancona",24,2094,83,0,0,2177,1852,322,1,0,2175
"042","Ancona",25,2208,119,0,0,2327,1925,386,2,0,2313
"042","Ancona",26,2173,169,0,0,2342,1861,523,9,0,2393
"042","Ancona",27,2264,288,0,0,2552,1808,681,6,1,2496
"042","Ancona",28,2147,345,2,0,2494,1731,815,10,3,2559
"042","Ancona",29,2236,459,0,0,2695,1584,1012,12,2,2610
"042","Ancona",30,2067,650,3,1,2721,1476,1154,12,2,2644
"042","Ancona",31,2107,847,4,1,2959,1525,1428,25,4,2982
"042","Ancona",32,2014,1120,8,0,3142,1318,1604,27,6,2955
"042","Ancona",33,2004,1271,12,2,3289,1327,1835,44,8,3214
"042","Ancona",34,1935,1455,14,1,3405,1255,1986,40,11,3292
"042","Ancona",35,1760,1595,32,2,3389,1274,2143,62,11,3490
"042","Ancona",36,1818,1889,44,1,3752,1199,2416,89,14,3718
"042","Ancona",37,1775,2061,36,1,3873,1099,2441,97,10,3647
"042","Ancona",38,1496,2113,45,1,3655,998,2527,96,22,3643
"042","Ancona",39,1435,2254,61,3,3753,975,2630,115,22,3742
"042","Ancona",40,1384,2421,72,4,3881,919,2685,148,15,3767
"042","Ancona",41,1171,2428,84,5,3688,789,2732,154,34,3709
"042","Ancona",42,1078,2465,96,5,3644,812,2826,169,38,3845
"042","Ancona",43,1020,2519,99,5,3643,690,2887,192,37,3806
"042","Ancona",44,963,2531,120,7,3621,640,2820,177,46,3683
"042","Ancona",45,858,2797,132,25,3812,648,2895,196,47,3786
"042","Ancona",46,799,2762,126,18,3705,599,2797,207,42,3645
"042","Ancona",47,777,2842,169,9,3797,546,3040,197,70,3853
"042","Ancona",48,686,2720,135,18,3559,530,2847,234,74,3685
"042","Ancona",49,611,2680,160,25,3476,428,2686,195,73,3382
"042","Ancona",50,524,2709,146,18,3397,421,2737,196,82,3436
"042","Ancona",51,507,2507,147,21,3182,439,2586,171,93,3289
"042","Ancona",52,454,2483,136,21,3094,354,2716,169,121,3360
"042","Ancona",53,420,2475,138,36,3069,384,2564,169,111,3228
"042","Ancona",54,386,2481,123,34,3024,310,2563,159,140,3172
"042","Ancona",55,377,2487,141,46,3051,333,2654,179,178,3344
"042","Ancona",56,344,2429,126,34,2933,284,2534,151,182,3151
"042","Ancona",57,305,2408,95,42,2850,282,2406,151,179,3018
"042","Ancona",58,270,2271,105,45,2691,242,2490,145,221,3098
"042","Ancona",59,267,2338,115,53,2773,213,2412,141,219,2985
"042","Ancona",60,262,2433,106,50,2851,216,2424,105,259,3004
"042","Ancona",61,279,2466,104,63,2912,210,2450,124,287,3071
"042","Ancona",62,213,2386,65,71,2735,186,2337,118,318,2959
"042","Ancona",63,247,2503,54,90,2894,187,2374,105,351,3017
"042","Ancona",64,221,2452,66,81,2820,162,2275,100,448,2985
"042","Ancona",65,246,2439,92,109,2886,180,2391,90,478,3139
"042","Ancona",66,188,2067,64,113,2432,132,1857,65,434,2488
"042","Ancona",67,168,1881,47,92,2188,145,1843,63,464,2515
"042","Ancona",68,173,2034,51,102,2360,149,1998,39,517,2703
"042","Ancona",69,195,1856,45,133,2229,149,1787,51,603,2590
"042","Ancona",70,178,1873,38,122,2211,169,1736,53,625,2583
"042","Ancona",71,170,2088,25,145,2428,172,1896,53,818,2939
"042","Ancona",72,189,2062,43,146,2440,168,1851,43,906,2968
"042","Ancona",73,187,1958,42,166,2353,205,1713,35,979,2932
"042","Ancona",74,149,1927,30,158,2264,160,1565,35,951,2711
"042","Ancona",75,128,1660,17,182,1987,156,1422,30,1046,2654
"042","Ancona",76,143,1719,18,173,2053,183,1288,31,1193,2695
"042","Ancona",77,129,1614,16,175,1934,170,1113,22,1274,2579
"042","Ancona",78,94,1490,14,198,1796,168,1008,16,1307,2499
"042","Ancona",79,98,1318,13,193,1622,156,836,26,1263,2281
"042","Ancona",80,100,1337,8,219,1664,171,862,19,1440,2492
"042","Ancona",81,83,1358,10,224,1675,185,744,18,1447,2394
"042","Ancona",82,77,1099,14,218,1408,171,582,9,1335,2097
"042","Ancona",83,58,974,7,199,1238,196,519,12,1438,2165
"042","Ancona",84,59,893,5,217,1174,178,434,11,1409,2032
"042","Ancona",85,49,748,9,224,1030,155,364,8,1380,1907
"042","Ancona",86,43,674,3,220,940,162,294,9,1379,1844
"042","Ancona",87,32,535,1,228,796,147,217,7,1231,1602
"042","Ancona",88,24,473,3,216,716,133,147,4,1174,1458
"042","Ancona",89,19,343,2,185,549,109,109,8,1029,1255
"042","Ancona",90,14,270,1,181,466,90,83,3,920,1096
"042","Ancona",91,14,245,2,126,387,79,57,3,849,988
"042","Ancona",92,3,104,0,84,191,51,21,0,419,491
"042","Ancona",93,2,50,3,51,106,18,8,10,282,318
"042","Ancona",94,5,26,0,35,66,18,8,0,253,279
"042","Ancona",95,2,24,0,38,64,31,5,1,235,272
"042","Ancona",96,4,31,1,62,98,28,8,0,210,246
"042","Ancona",97,1,19,0,30,50,14,3,0,171,188
"042","Ancona",98,2,11,0,15,28,17,0,0,101,118
"042","Ancona",99,1,9,0,12,22,10,2,0,78,90
"042","Ancona",100,2,6,0,24,32,18,2,6,97,123
"043","Macerata",0,1428,0,0,0,1428,1406,0,0,0,1406
"043","Macerata",1,1534,0,0,0,1534,1368,0,0,0,1368
"043","Macerata",2,1494,0,0,0,1494,1503,0,0,0,1503
"043","Macerata",3,1467,0,0,0,1467,1363,0,0,0,1363
"043","Macerata",4,1482,0,0,0,1482,1425,0,0,0,1425
"043","Macerata",5,1416,0,0,0,1416,1403,0,0,0,1403
"043","Macerata",6,1447,0,0,0,1447,1389,0,0,0,1389
"043","Macerata",7,1475,0,0,0,1475,1319,0,0,0,1319
"043","Macerata",8,1469,0,0,0,1469,1326,0,0,0,1326
"043","Macerata",9,1423,0,0,0,1423,1350,0,0,0,1350
"043","Macerata",10,1374,0,0,0,1374,1359,0,0,0,1359
"043","Macerata",11,1500,0,0,0,1500,1368,0,0,0,1368
"043","Macerata",12,1427,0,0,0,1427,1380,0,0,0,1380
"043","Macerata",13,1455,0,0,0,1455,1354,0,0,0,1354
"043","Macerata",14,1507,0,0,0,1507,1347,0,0,0,1347
"043","Macerata",15,1420,0,0,0,1420,1357,0,0,0,1357
"043","Macerata",16,1406,0,0,0,1406,1364,0,0,0,1364
"043","Macerata",17,1458,0,0,0,1458,1364,0,0,0,1364
"043","Macerata",18,1596,1,0,0,1597,1414,3,0,0,1417
"043","Macerata",19,1577,1,0,0,1578,1482,19,0,0,1501
"043","Macerata",20,1525,4,0,0,1529,1473,38,0,0,1511
"043","Macerata",21,1635,15,0,0,1650,1508,75,0,0,1583
"043","Macerata",22,1578,28,0,0,1606,1385,134,1,0,1520
"043","Macerata",23,1629,36,0,0,1665,1506,172,1,0,1679
"043","Macerata",24,1554,76,1,0,1631,1383,232,0,0,1615
"043","Macerata",25,1584,114,1,0,1699,1407,283,2,1,1693
"043","Macerata",26,1607,147,0,0,1754,1384,410,2,1,1797
"043","Macerata",27,1507,186,0,0,1693,1273,514,4,2,1793
"043","Macerata",28,1467,243,3,0,1713,1196,609,3,1,1809
"043","Macerata",29,1481,369,2,0,1852,1183,742,3,0,1928
"043","Macerata",30,1424,483,7,0,1914,1013,899,10,1,1923
"043","Macerata",31,1342,592,3,0,1937,917,1037,9,0,1963
"043","Macerata",32,1289,701,5,1,1996,874,1200,17,2,2093
"043","Macerata",33,1289,887,3,0,2179,804,1242,23,5,2074
"043","Macerata",34,1211,977,11,0,2199,770,1403,33,7,2213
"043","Macerata",35,1150,1127,18,1,2296,709,1492,26,3,2230
"043","Macerata",36,1084,1225,13,1,2323,715,1574,55,9,2353
"043","Macerata",37,995,1373,25,2,2395,663,1654,55,9,2381
"043","Macerata",38,909,1373,25,3,2310,647,1617,60,14,2338
"043","Macerata",39,918,1488,41,2,2449,536,1693,73,17,2319
"043","Macerata",40,888,1525,25,4,2442,544,1886,85,9,2524
"043","Macerata",41,752,1623,52,6,2433,473,1749,80,18,2320
"043","Macerata",42,754,1682,54,6,2496,461,1863,88,26,2438
"043","Macerata",43,652,1841,63,6,2562,418,1850,79,31,2378
"043","Macerata",44,626,1711,61,1,2399,432,1917,98,35,2482
"043","Macerata",45,592,1781,73,3,2449,393,1889,106,37,2425
"043","Macerata",46,533,1842,70,7,2452,365,1968,118,55,2506
"043","Macerata",47,559,1866,102,5,2532,343,1966,107,42,2458
"043","Macerata",48,444,1821,69,11,2345,339,1922,120,65,2446
"043","Macerata",49,396,1847,81,11,2335,258,1786,118,53,2215
"043","Macerata",50,421,1840,82,17,2360,311,1877,115,64,2367
"043","Macerata",51,345,1775,92,18,2230,266,1859,120,71,2316
"043","Macerata",52,351,1730,81,18,2180,225,1850,95,93,2263
"043","Macerata",53,309,1725,81,23,2138,220,1707,120,87,2134
"043","Macerata",54,260,1660,72,26,2018,234,1733,123,102,2192
"043","Macerata",55,261,1684,68,33,2046,223,1651,100,114,2088
"043","Macerata",56,242,1610,75,31,1958,200,1709,90,131,2130
"043","Macerata",57,250,1649,69,27,1995,176,1671,84,118,2049
"043","Macerata",58,235,1621,75,29,1960,160,1560,78,155,1953
"043","Macerata",59,232,1660,65,42,1999,183,1562,69,178,1992
"043","Macerata",60,230,1595,57,44,1926,164,1680,84,189,2117
"043","Macerata",61,199,1669,58,45,1971,136,1633,81,197,2047
"043","Macerata",62,215,1582,66,39,1902,120,1484,62,233,1899
"043","Macerata",63,175,1576,52,53,1856,146,1630,41,253,2070
"043","Macerata",64,204,1572,48,51,1875,93,1508,49,279,1929
"043","Macerata",65,177,1463,40,58,1738,97,1471,48,289,1905
"043","Macerata",66,121,1276,32,52,1481,100,1247,41,271,1659
"043","Macerata",67,153,1251,40,58,1502,98,1158,31,338,1625
"043","Macerata",68,149,1277,35,65,1526,97,1164,37,355,1653
"043","Macerata",69,130,1195,23,70,1418,72,1171,27,403,1673
"043","Macerata",70,137,1192,22,70,1421,94,1148,22,428,1692
"043","Macerata",71,161,1406,30,102,1699,90,1255,42,524,1911
"043","Macerata",72,166,1466,17,96,1745,123,1270,36,618,2047
"043","Macerata",73,141,1478,20,112,1751,109,1164,24,787,2084
"043","Macerata",74,149,1362,14,134,1659,106,1095,13,707,1921
"043","Macerata",75,110,1140,19,113,1382,107,893,19,728,1747
"043","Macerata",76,123,1212,14,118,1467,102,893,15,834,1844
"043","Macerata",77,92,1163,11,135,1401,107,739,11,837,1694
"043","Macerata",78,114,1008,4,132,1258,89,698,9,851,1647
"043","Macerata",79,104,915,6,134,1159,103,602,10,838,1553
"043","Macerata",80,74,971,8,159,1212,108,503,9,936,1556
"043","Macerata",81,78,874,8,144,1104,128,504,14,1065,1711
"043","Macerata",82,77,773,4,151,1005,92,388,14,937,1431
"043","Macerata",83,65,751,7,139,962,112,325,8,992,1437
"043","Macerata",84,50,626,4,179,859,90,283,9,1064,1446
"043","Macerata",85,40,515,3,170,728,109,228,5,990,1332
"043","Macerata",86,34,473,2,139,648,103,192,7,934,1236
"043","Macerata",87,37,374,1,142,554,93,124,5,801,1023
"043","Macerata",88,21,317,1,143,482,87,109,2,774,972
"043","Macerata",89,15,239,3,127,384,100,72,3,682,857
"043","Macerata",90,16,220,4,119,359,54,43,3,677,777
"043","Macerata",91,9,167,0,88,264,50,26,7,530,613
"043","Macerata",92,11,67,0,75,153,38,18,0,287,343
"043","Macerata",93,3,39,0,38,80,18,3,1,194,216
"043","Macerata",94,3,21,0,28,52,20,6,0,160,186
"043","Macerata",95,5,37,0,22,64,14,7,0,159,180
"043","Macerata",96,3,9,0,26,38,22,3,0,150,175
"043","Macerata",97,2,19,1,22,44,14,1,0,111,126
"043","Macerata",98,0,6,0,14,20,5,2,0,84,91
"043","Macerata",99,1,4,0,9,14,4,0,0,45,49
"043","Macerata",100,1,4,0,14,19,16,0,0,73,89
"044","Ascoli Piceno",0,863,0,0,0,863,812,0,0,0,812
"044","Ascoli Piceno",1,863,0,0,0,863,852,0,0,0,852
"044","Ascoli Piceno",2,878,0,0,0,878,850,0,0,0,850
"044","Ascoli Piceno",3,948,0,0,0,948,876,0,0,0,876
"044","Ascoli Piceno",4,900,0,0,0,900,840,0,0,0,840
"044","Ascoli Piceno",5,931,0,0,0,931,837,0,0,0,837
"044","Ascoli Piceno",6,874,0,0,0,874,871,0,0,0,871
"044","Ascoli Piceno",7,939,0,0,0,939,892,0,0,0,892
"044","Ascoli Piceno",8,915,0,0,0,915,808,0,0,0,808
"044","Ascoli Piceno",9,923,0,0,0,923,803,0,0,0,803
"044","Ascoli Piceno",10,911,0,0,0,911,823,0,0,0,823
"044","Ascoli Piceno",11,1004,0,0,0,1004,907,0,0,0,907
"044","Ascoli Piceno",12,951,0,0,0,951,921,0,0,0,921
"044","Ascoli Piceno",13,1041,0,0,0,1041,951,0,0,0,951
"044","Ascoli Piceno",14,935,0,0,0,935,919,0,0,0,919
"044","Ascoli Piceno",15,996,0,0,0,996,887,0,0,0,887
"044","Ascoli Piceno",16,1025,0,0,0,1025,916,0,0,0,916
"044","Ascoli Piceno",17,980,0,0,0,980,940,0,0,0,940
"044","Ascoli Piceno",18,1063,0,0,0,1063,980,2,0,0,982
"044","Ascoli Piceno",19,1087,0,0,0,1087,1006,10,0,0,1016
"044","Ascoli Piceno",20,1113,2,0,0,1115,988,17,0,0,1005
"044","Ascoli Piceno",21,1116,5,0,0,1121,986,23,0,0,1009
"044","Ascoli Piceno",22,1100,10,0,0,1110,998,51,1,0,1050
"044","Ascoli Piceno",23,1100,17,0,0,1117,1025,77,0,0,1102
"044","Ascoli Piceno",24,1101,31,0,0,1132,927,105,0,1,1033
"044","Ascoli Piceno",25,1097,34,0,0,1131,907,165,0,0,1072
"044","Ascoli Piceno",26,1069,70,0,0,1139,926,223,4,0,1153
"044","Ascoli Piceno",27,1089,105,0,0,1194,832,298,0,0,1130
"044","Ascoli Piceno",28,1022,156,0,0,1178,797,383,2,0,1182
"044","Ascoli Piceno",29,983,235,0,0,1218,777,384,3,1,1165
"044","Ascoli Piceno",30,975,264,1,0,1240,706,528,3,0,1237
"044","Ascoli Piceno",31,917,400,0,0,1317,619,588,7,1,1215
"044","Ascoli Piceno",32,860,458,1,0,1319,599,706,8,2,1315
"044","Ascoli Piceno",33,846,455,6,1,1308,546,807,21,2,1376
"044","Ascoli Piceno",34,729,562,2,1,1294,509,889,21,4,1423
"044","Ascoli Piceno",35,729,681,6,0,1416,463,890,28,4,1385
"044","Ascoli Piceno",36,722,746,9,1,1478,468,963,25,3,1459
"044","Ascoli Piceno",37,703,840,11,0,1554,422,1064,34,4,1524
"044","Ascoli Piceno",38,622,878,14,3,1517,363,1101,42,7,1513
"044","Ascoli Piceno",39,638,961,24,2,1625,392,1184,42,11,1629
"044","Ascoli Piceno",40,548,991,25,3,1567,330,1174,51,12,1567
"044","Ascoli Piceno",41,530,993,23,1,1547,306,1273,59,9,1647
"044","Ascoli Piceno",42,496,1109,22,2,1629,319,1300,62,12,1693
"044","Ascoli Piceno",43,445,1187,40,4,1676,297,1322,61,17,1697
"044","Ascoli Piceno",44,418,1170,44,2,1634,233,1352,66,20,1671
"044","Ascoli Piceno",45,353,1165,42,5,1565,239,1351,76,26,1692
"044","Ascoli Piceno",46,342,1323,45,6,1716,223,1404,53,30,1710
"044","Ascoli Piceno",47,325,1369,36,9,1739,241,1461,96,33,1831
"044","Ascoli Piceno",48,281,1283,57,5,1626,216,1385,77,30,1708
"044","Ascoli Piceno",49,250,1237,59,6,1552,192,1255,75,47,1569
"044","Ascoli Piceno",50,222,1243,54,8,1527,182,1256,80,42,1560
"044","Ascoli Piceno",51,202,1264,45,12,1523,169,1247,70,45,1531
"044","Ascoli Piceno",52,197,1199,40,4,1440,172,1216,66,70,1524
"044","Ascoli Piceno",53,186,1136,28,14,1364,165,1293,78,65,1601
"044","Ascoli Piceno",54,160,1131,49,13,1353,152,1230,65,69,1516
"044","Ascoli Piceno",55,181,1158,45,14,1398,128,1216,66,95,1505
"044","Ascoli Piceno",56,142,1123,40,12,1317,135,1181,56,97,1469
"044","Ascoli Piceno",57,145,1062,43,15,1265,112,1166,46,82,1406
"044","Ascoli Piceno",58,113,1089,39,15,1256,124,1113,48,104,1389
"044","Ascoli Piceno",59,128,1052,37,22,1239,100,1119,41,112,1372
"044","Ascoli Piceno",60,122,1044,41,24,1231,64,1086,40,128,1318
"044","Ascoli Piceno",61,109,1131,39,29,1308,80,1090,41,146,1357
"044","Ascoli Piceno",62,99,1077,26,26,1228,82,1071,35,158,1346
"044","Ascoli Piceno",63,89,1106,20,31,1246,90,1111,25,216,1442
"044","Ascoli Piceno",64,86,1079,34,31,1230,89,1051,36,207,1383
"044","Ascoli Piceno",65,86,1023,26,35,1170,81,1003,42,201,1327
"044","Ascoli Piceno",66,72,867,26,36,1001,42,845,26,220,1133
"044","Ascoli Piceno",67,66,842,23,35,966,52,708,21,224,1005
"044","Ascoli Piceno",68,72,944,22,39,1077,65,798,24,267,1154
"044","Ascoli Piceno",69,66,902,21,36,1025,52,798,15,282,1147
"044","Ascoli Piceno",70,75,862,17,49,1003,72,767,15,282,1136
"044","Ascoli Piceno",71,75,1024,15,67,1181,75,839,24,392,1330
"044","Ascoli Piceno",72,73,1000,21,75,1169,64,804,14,409,1291
"044","Ascoli Piceno",73,74,975,15,70,1134,77,760,18,477,1332
"044","Ascoli Piceno",74,63,904,14,70,1051,68,660,12,468,1208
"044","Ascoli Piceno",75,60,796,7,77,940,77,596,12,466,1151
"044","Ascoli Piceno",76,48,822,5,87,962,71,532,8,546,1157
"044","Ascoli Piceno",77,51,773,7,91,922,58,495,7,531,1091
"044","Ascoli Piceno",78,48,755,4,88,895,77,450,10,593,1130
"044","Ascoli Piceno",79,38,610,5,83,736,76,358,7,526,967
"044","Ascoli Piceno",80,45,612,4,97,758,78,348,10,605,1041
"044","Ascoli Piceno",81,36,592,5,114,747,65,321,5,680,1071
"044","Ascoli Piceno",82,44,501,2,104,651,76,257,3,576,912
"044","Ascoli Piceno",83,39,457,2,105,603,75,217,6,680,978
"044","Ascoli Piceno",84,27,391,1,107,526,67,172,5,635,879
"044","Ascoli Piceno",85,16,359,2,90,467,69,159,5,529,762
"044","Ascoli Piceno",86,14,293,1,93,401,68,124,4,596,792
"044","Ascoli Piceno",87,21,221,2,89,333,71,106,6,515,698
"044","Ascoli Piceno",88,17,192,0,74,283,50,70,1,472,593
"044","Ascoli Piceno",89,13,167,0,66,246,33,43,2,425,503
"044","Ascoli Piceno",90,12,130,0,56,198,37,34,1,354,426
"044","Ascoli Piceno",91,8,80,0,47,135,35,22,1,294,352
"044","Ascoli Piceno",92,5,42,0,39,86,12,14,0,193,219
"044","Ascoli Piceno",93,3,24,0,16,43,13,10,0,83,106
"044","Ascoli Piceno",94,2,14,0,26,42,16,6,2,93,117
"044","Ascoli Piceno",95,0,11,0,13,24,9,6,0,87,102
"044","Ascoli Piceno",96,0,17,0,20,37,5,1,0,81,87
"044","Ascoli Piceno",97,0,5,0,11,16,11,0,0,56,67
"044","Ascoli Piceno",98,1,8,0,12,21,7,2,0,50,59
"044","Ascoli Piceno",99,1,4,0,7,12,3,0,0,35,38
"044","Ascoli Piceno",100,0,2,0,8,10,5,1,0,34,40
"045","Massa-Carrara",0,725,0,0,0,725,777,0,0,0,777
"045","Massa-Carrara",1,746,0,0,0,746,766,0,0,0,766
"045","Massa-Carrara",2,731,0,0,0,731,730,0,0,0,730
"045","Massa-Carrara",3,854,0,0,0,854,785,0,0,0,785
"045","Massa-Carrara",4,814,0,0,0,814,783,0,0,0,783
"045","Massa-Carrara",5,850,0,0,0,850,739,0,0,0,739
"045","Massa-Carrara",6,831,0,0,0,831,734,0,0,0,734
"045","Massa-Carrara",7,749,0,0,0,749,772,0,0,0,772
"045","Massa-Carrara",8,784,0,0,0,784,754,0,0,0,754
"045","Massa-Carrara",9,831,0,0,0,831,762,0,0,0,762
"045","Massa-Carrara",10,795,0,0,0,795,761,0,0,0,761
"045","Massa-Carrara",11,823,0,0,0,823,720,0,0,0,720
"045","Massa-Carrara",12,768,0,0,0,768,757,0,0,0,757
"045","Massa-Carrara",13,797,0,0,0,797,774,0,0,0,774
"045","Massa-Carrara",14,771,0,0,0,771,711,0,0,0,711
"045","Massa-Carrara",15,810,0,0,0,810,764,0,0,0,764
"045","Massa-Carrara",16,846,0,0,0,846,782,0,0,0,782
"045","Massa-Carrara",17,791,0,0,0,791,770,0,0,0,770
"045","Massa-Carrara",18,856,1,0,0,857,779,5,0,0,784
"045","Massa-Carrara",19,841,0,1,0,842,771,12,0,0,783
"045","Massa-Carrara",20,915,5,0,0,920,807,30,0,0,837
"045","Massa-Carrara",21,893,3,0,0,896,814,33,1,1,849
"045","Massa-Carrara",22,897,9,0,0,906,791,41,0,0,832
"045","Massa-Carrara",23,964,17,0,0,981,781,91,1,1,874
"045","Massa-Carrara",24,879,32,0,0,911,774,121,0,0,895
"045","Massa-Carrara",25,926,44,1,0,971,733,149,0,0,882
"045","Massa-Carrara",26,898,78,1,0,977,762,206,2,1,971
"045","Massa-Carrara",27,963,113,0,0,1076,695,272,1,0,968
"045","Massa-Carrara",28,949,153,1,0,1103,699,317,3,1,1020
"045","Massa-Carrara",29,883,190,1,0,1074,617,428,6,3,1054
"045","Massa-Carrara",30,805,256,4,0,1065,632,463,11,1,1107
"045","Massa-Carrara",31,847,321,3,0,1171,582,508,6,1,1097
"045","Massa-Carrara",32,799,362,5,0,1166,539,570,17,3,1129
"045","Massa-Carrara",33,798,434,3,0,1235,539,614,24,5,1182
"045","Massa-Carrara",34,819,538,8,0,1365,574,751,32,5,1362
"045","Massa-Carrara",35,772,625,17,0,1414,518,802,38,3,1361
"045","Massa-Carrara",36,749,728,15,2,1494,537,869,51,8,1465
"045","Massa-Carrara",37,699,713,21,1,1434,476,970,66,5,1517
"045","Massa-Carrara",38,679,779,46,3,1507,431,1007,66,7,1511
"045","Massa-Carrara",39,617,901,34,3,1555,380,1039,61,7,1487
"045","Massa-Carrara",40,630,884,40,2,1556,394,982,84,11,1471
"045","Massa-Carrara",41,538,966,53,1,1558,306,1105,102,19,1532
"045","Massa-Carrara",42,537,993,62,4,1596,368,1174,95,20,1657
"045","Massa-Carrara",43,443,1000,62,1,1506,300,1152,80,29,1561
"045","Massa-Carrara",44,417,1009,62,2,1490,301,1117,98,24,1540
"045","Massa-Carrara",45,441,1080,71,6,1598,258,1196,121,29,1604
"045","Massa-Carrara",46,381,1181,77,7,1646,247,1233,109,26,1615
"045","Massa-Carrara",47,359,1255,89,9,1712,230,1317,125,40,1712
"045","Massa-Carrara",48,299,1258,97,5,1659,209,1318,123,37,1687
"045","Massa-Carrara",49,294,1202,93,11,1600,188,1192,119,53,1552
"045","Massa-Carrara",50,290,1111,87,13,1501,166,1248,101,52,1567
"045","Massa-Carrara",51,227,1082,90,10,1409,178,1105,117,59,1459
"045","Massa-Carrara",52,227,1147,87,11,1472,155,1135,107,60,1457
"045","Massa-Carrara",53,214,1081,67,18,1380,151,1223,105,77,1556
"045","Massa-Carrara",54,212,1089,71,13,1385,128,1181,101,94,1504
"045","Massa-Carrara",55,195,1138,78,11,1422,108,1152,85,102,1447
"045","Massa-Carrara",56,158,1053,67,24,1302,131,1165,86,84,1466
"045","Massa-Carrara",57,165,1100,64,22,1351,107,1067,76,116,1366
"045","Massa-Carrara",58,131,1029,44,31,1235,96,1060,64,127,1347
"045","Massa-Carrara",59,116,1050,38,23,1227,80,988,51,122,1241
"045","Massa-Carrara",60,115,956,53,33,1157,78,945,60,109,1192
"045","Massa-Carrara",61,120,1076,66,35,1297,94,1009,65,175,1343
"045","Massa-Carrara",62,128,1069,40,36,1273,75,1032,75,169,1351
"045","Massa-Carrara",63,131,1169,57,41,1398,83,1088,67,204,1442
"045","Massa-Carrara",64,109,1185,61,49,1404,66,1150,49,250,1515
"045","Massa-Carrara",65,134,1187,52,44,1417,59,1106,50,275,1490
"045","Massa-Carrara",66,63,715,37,43,858,50,738,32,192,1012
"045","Massa-Carrara",67,75,943,18,50,1086,64,906,55,268,1293
"045","Massa-Carrara",68,73,858,37,53,1021,48,776,26,245,1095
"045","Massa-Carrara",69,79,943,35,51,1108,55,779,25,280,1139
"045","Massa-Carrara",70,98,994,23,63,1178,63,873,35,362,1333
"045","Massa-Carrara",71,101,1013,26,69,1209,67,915,37,463,1482
"045","Massa-Carrara",72,77,938,25,82,1122,64,739,28,428,1259
"045","Massa-Carrara",73,81,909,26,94,1110,71,688,15,489,1263
"045","Massa-Carrara",74,84,785,22,104,995,49,684,19,495,1247
"045","Massa-Carrara",75,63,717,15,94,889,64,575,21,495,1155
"045","Massa-Carrara",76,58,687,15,64,824,65,562,17,572,1216
"045","Massa-Carrara",77,66,665,11,92,834,65,493,22,551,1131
"045","Massa-Carrara",78,61,610,10,108,789,56,433,13,583,1085
"045","Massa-Carrara",79,49,589,5,110,753,70,381,12,612,1075
"045","Massa-Carrara",80,46,516,9,119,690,54,353,20,643,1070
"045","Massa-Carrara",81,47,536,12,104,699,76,307,14,695,1092
"045","Massa-Carrara",82,38,452,9,122,621,74,279,7,723,1083
"045","Massa-Carrara",83,36,352,3,134,525,66,223,9,742,1040
"045","Massa-Carrara",84,35,350,8,102,495,67,174,6,690,937
"045","Massa-Carrara",85,22,268,0,112,402,61,145,8,634,848
"045","Massa-Carrara",86,28,230,3,97,358,48,122,5,589,764
"045","Massa-Carrara",87,21,197,1,96,315,56,93,6,602,757
"045","Massa-Carrara",88,19,151,2,76,248,56,69,3,500,628
"045","Massa-Carrara",89,13,116,2,77,208,40,59,3,456,558
"045","Massa-Carrara",90,7,89,1,80,177,43,54,2,403,502
"045","Massa-Carrara",91,5,74,0,59,138,27,28,6,384,445
"045","Massa-Carrara",92,3,33,0,16,52,16,11,4,202,233
"045","Massa-Carrara",93,1,15,1,21,38,6,8,4,125,143
"045","Massa-Carrara",94,1,19,0,10,30,8,4,1,117,130
"045","Massa-Carrara",95,0,15,0,12,27,9,2,0,100,111
"045","Massa-Carrara",96,1,11,0,12,24,6,4,0,102,112
"045","Massa-Carrara",97,2,5,0,15,22,12,1,0,81,94
"045","Massa-Carrara",98,1,5,0,5,11,5,1,0,45,51
"045","Massa-Carrara",99,0,3,0,3,6,3,0,0,45,48
"045","Massa-Carrara",100,0,3,0,4,7,4,2,0,62,68
"046","Lucca",0,1531,0,0,0,1531,1518,0,0,0,1518
"046","Lucca",1,1632,0,0,0,1632,1536,0,0,0,1536
"046","Lucca",2,1664,0,0,0,1664,1502,0,0,0,1502
"046","Lucca",3,1755,0,0,0,1755,1692,0,0,0,1692
"046","Lucca",4,1733,0,0,0,1733,1637,0,0,0,1637
"046","Lucca",5,1700,0,0,0,1700,1629,0,0,0,1629
"046","Lucca",6,1742,0,0,0,1742,1633,0,0,0,1633
"046","Lucca",7,1641,0,0,0,1641,1616,0,0,0,1616
"046","Lucca",8,1685,0,0,0,1685,1570,0,0,0,1570
"046","Lucca",9,1669,0,0,0,1669,1569,0,0,0,1569
"046","Lucca",10,1694,0,0,0,1694,1572,0,0,0,1572
"046","Lucca",11,1624,0,0,0,1624,1575,0,0,0,1575
"046","Lucca",12,1635,0,0,0,1635,1518,0,0,0,1518
"046","Lucca",13,1638,0,0,0,1638,1544,0,0,0,1544
"046","Lucca",14,1631,0,0,0,1631,1522,0,0,0,1522
"046","Lucca",15,1617,0,0,0,1617,1607,0,0,0,1607
"046","Lucca",16,1646,0,0,0,1646,1497,0,0,0,1497
"046","Lucca",17,1610,0,0,0,1610,1546,0,0,0,1546
"046","Lucca",18,1673,0,0,0,1673,1549,3,0,0,1552
"046","Lucca",19,1704,2,0,0,1706,1602,18,0,0,1620
"046","Lucca",20,1728,2,0,0,1730,1641,50,0,0,1691
"046","Lucca",21,1764,8,0,0,1772,1610,73,2,0,1685
"046","Lucca",22,1630,17,0,0,1647,1510,112,1,0,1623
"046","Lucca",23,1793,27,3,0,1823,1628,167,1,0,1796
"046","Lucca",24,1680,62,6,0,1748,1446,242,1,0,1689
"046","Lucca",25,1732,88,4,0,1824,1408,260,1,0,1669
"046","Lucca",26,1707,135,5,0,1847,1472,392,5,1,1870
"046","Lucca",27,1728,229,5,0,1962,1357,497,5,0,1859
"046","Lucca",28,1670,283,7,0,1960,1287,593,1,8,1889
"046","Lucca",29,1666,381,7,0,2054,1296,748,7,0,2051
"046","Lucca",30,1638,478,5,0,2121,1150,888,22,2,2062
"046","Lucca",31,1523,659,14,1,2197,1152,1078,25,8,2263
"046","Lucca",32,1496,736,16,0,2248,1082,1170,27,9,2288
"046","Lucca",33,1457,928,18,1,2404,1060,1362,40,6,2468
"046","Lucca",34,1520,1097,17,0,2634,1033,1493,73,8,2607
"046","Lucca",35,1466,1214,34,2,2716,1019,1598,63,14,2694
"046","Lucca",36,1437,1408,49,1,2895,1016,1801,89,12,2918
"046","Lucca",37,1349,1517,54,0,2920,952,1952,109,12,3025
"046","Lucca",38,1269,1672,55,6,3002,876,2040,133,13,3062
"046","Lucca",39,1146,1776,76,3,3001,793,2175,149,22,3139
"046","Lucca",40,1117,1855,113,2,3087,790,2239,173,35,3237
"046","Lucca",41,1062,1886,109,5,3062,660,2223,174,27,3084
"046","Lucca",42,955,2050,126,5,3136,684,2298,203,38,3223
"046","Lucca",43,845,2215,130,9,3199,622,2395,216,37,3270
"046","Lucca",44,851,2182,145,10,3188,567,2362,233,46,3208
"046","Lucca",45,776,2273,159,17,3225,589,2361,220,49,3219
"046","Lucca",46,720,2372,198,17,3307,565,2574,244,73,3456
"046","Lucca",47,679,2389,204,7,3279,489,2571,274,70,3404
"046","Lucca",48,619,2307,187,14,3127,381,2380,263,85,3109
"046","Lucca",49,578,2143,137,11,2869,411,2267,242,109,3029
"046","Lucca",50,469,2217,153,18,2857,376,2342,258,94,3070
"046","Lucca",51,482,2290,179,31,2982,368,2183,222,95,2868
"046","Lucca",52,421,2098,170,22,2711,309,2204,227,115,2855
"046","Lucca",53,366,2039,154,30,2589,292,2118,200,96,2706
"046","Lucca",54,340,1942,144,25,2451,262,2130,200,128,2720
"046","Lucca",55,335,2021,166,32,2554,224,2034,183,151,2592
"046","Lucca",56,329,1869,165,43,2406,216,2022,172,153,2563
"046","Lucca",57,288,2008,135,35,2466,208,2003,190,155,2556
"046","Lucca",58,252,1892,149,42,2335,220,1877,156,199,2452
"046","Lucca",59,255,1884,124,49,2312,188,2006,133,230,2557
"046","Lucca",60,213,1899,105,42,2259,151,1962,148,212,2473
"046","Lucca",61,253,2018,109,60,2440,180,1936,149,268,2533
"046","Lucca",62,238,2036,116,66,2456,159,1959,117,298,2533
"046","Lucca",63,257,2204,112,74,2647,190,2148,125,332,2795
"046","Lucca",64,241,2160,100,92,2593,161,2139,105,402,2807
"046","Lucca",65,234,2242,90,120,2686,147,2137,119,487,2890
"046","Lucca",66,185,1639,70,86,1980,122,1600,89,383,2194
"046","Lucca",67,186,1758,67,99,2110,137,1657,85,492,2371
"046","Lucca",68,163,1688,55,124,2030,116,1634,75,481,2306
"046","Lucca",69,200,1696,51,121,2068,135,1579,77,553,2344
"046","Lucca",70,180,1782,47,117,2126,128,1587,72,596,2383
"046","Lucca",71,208,1804,48,141,2201,147,1665,69,770,2651
"046","Lucca",72,171,1739,51,151,2112,149,1554,47,755,2505
"046","Lucca",73,153,1808,41,167,2169,141,1444,60,856,2501
"046","Lucca",74,169,1557,38,161,1925,145,1264,49,807,2265
"046","Lucca",75,148,1405,38,169,1760,131,1053,57,902,2143
"046","Lucca",76,132,1407,28,200,1767,129,1038,53,936,2156
"046","Lucca",77,127,1241,33,182,1583,142,930,34,1006,2112
"046","Lucca",78,108,1112,23,179,1422,147,789,34,1011,1981
"046","Lucca",79,105,1005,19,186,1315,134,722,31,1022,1909
"046","Lucca",80,123,920,11,202,1256,174,650,27,1127,1978
"046","Lucca",81,110,921,13,215,1259,145,567,24,1251,1987
"046","Lucca",82,87,796,14,190,1087,136,469,22,1168,1795
"046","Lucca",83,89,730,10,208,1037,147,388,14,1117,1666
"046","Lucca",84,64,599,3,200,866,152,330,25,1161,1668
"046","Lucca",85,60,489,12,205,766,142,269,18,1070,1499
"046","Lucca",86,61,407,3,188,659,152,213,13,1025,1403
"046","Lucca",87,48,336,2,190,576,161,194,8,1008,1371
"046","Lucca",88,26,280,4,161,471,120,142,12,937,1211
"046","Lucca",89,21,189,2,132,344,93,86,11,830,1020
"046","Lucca",90,17,175,2,136,330,86,74,7,726,893
"046","Lucca",91,14,118,1,96,229,67,71,7,615,760
"046","Lucca",92,10,62,0,43,115,33,22,4,337,396
"046","Lucca",93,5,36,0,34,75,25,14,3,177,219
"046","Lucca",94,4,21,0,33,58,25,15,1,144,185
"046","Lucca",95,1,23,0,37,61,20,8,1,176,205
"046","Lucca",96,2,24,0,30,56,22,9,1,186,218
"046","Lucca",97,3,13,0,19,35,17,13,2,126,158
"046","Lucca",98,3,3,0,17,23,6,3,1,87,97
"046","Lucca",99,2,6,0,12,20,8,2,0,69,79
"046","Lucca",100,0,2,0,15,17,17,4,1,100,122
"047","Pistoia",0,1309,0,0,0,1309,1211,0,0,0,1211
"047","Pistoia",1,1261,0,0,0,1261,1224,0,0,0,1224
"047","Pistoia",2,1284,0,0,0,1284,1198,0,0,0,1198
"047","Pistoia",3,1347,0,0,0,1347,1279,0,0,0,1279
"047","Pistoia",4,1325,0,0,0,1325,1214,0,0,0,1214
"047","Pistoia",5,1298,0,0,0,1298,1268,0,0,0,1268
"047","Pistoia",6,1286,0,0,0,1286,1210,0,0,0,1210
"047","Pistoia",7,1250,0,0,0,1250,1227,0,0,0,1227
"047","Pistoia",8,1235,0,0,0,1235,1207,0,0,0,1207
"047","Pistoia",9,1323,0,0,0,1323,1150,0,0,0,1150
"047","Pistoia",10,1222,0,0,0,1222,1227,0,0,0,1227
"047","Pistoia",11,1311,0,0,0,1311,1219,0,0,0,1219
"047","Pistoia",12,1219,0,0,0,1219,1151,0,0,0,1151
"047","Pistoia",13,1259,0,0,0,1259,1173,0,0,0,1173
"047","Pistoia",14,1202,0,0,0,1202,1187,0,0,0,1187
"047","Pistoia",15,1176,0,0,0,1176,1135,0,0,0,1135
"047","Pistoia",16,1198,0,0,0,1198,1082,0,0,0,1082
"047","Pistoia",17,1186,0,0,0,1186,1087,1,0,0,1088
"047","Pistoia",18,1197,0,0,0,1197,1157,5,0,0,1162
"047","Pistoia",19,1227,0,0,0,1227,1169,20,0,0,1189
"047","Pistoia",20,1310,1,0,0,1311,1079,71,0,0,1150
"047","Pistoia",21,1283,3,0,0,1286,1155,88,0,0,1243
"047","Pistoia",22,1300,14,0,0,1314,1156,121,1,0,1278
"047","Pistoia",23,1316,23,0,0,1339,1155,147,0,0,1302
"047","Pistoia",24,1231,46,0,0,1277,1101,201,5,1,1308
"047","Pistoia",25,1202,73,0,0,1275,1123,301,4,1,1429
"047","Pistoia",26,1315,109,1,0,1425,1182,320,1,0,1503
"047","Pistoia",27,1327,158,1,0,1486,987,377,8,0,1372
"047","Pistoia",28,1274,239,0,1,1514,962,483,8,2,1455
"047","Pistoia",29,1185,315,0,0,1500,990,636,3,0,1629
"047","Pistoia",30,1114,446,3,0,1563,894,729,10,2,1635
"047","Pistoia",31,1104,499,3,0,1606,916,836,13,2,1767
"047","Pistoia",32,1185,607,4,2,1798,838,980,24,3,1845
"047","Pistoia",33,1081,790,8,0,1879,822,1031,27,5,1885
"047","Pistoia",34,1048,895,11,2,1956,887,1143,40,8,2078
"047","Pistoia",35,1042,945,13,1,2001,816,1284,39,9,2148
"047","Pistoia",36,1029,1143,20,2,2194,783,1370,57,5,2215
"047","Pistoia",37,963,1214,26,1,2204,713,1486,72,12,2283
"047","Pistoia",38,920,1364,27,3,2314,673,1587,74,17,2351
"047","Pistoia",39,926,1362,41,4,2333,607,1538,100,16,2261
"047","Pistoia",40,813,1487,48,3,2351,601,1701,110,12,2424
"047","Pistoia",41,729,1497,67,10,2303,563,1651,126,12,2352
"047","Pistoia",42,699,1620,78,7,2404,506,1738,111,12,2367
"047","Pistoia",43,655,1533,72,3,2263,488,1757,126,22,2393
"047","Pistoia",44,566,1646,77,5,2294,502,1756,125,17,2400
"047","Pistoia",45,533,1687,102,5,2327,393,1811,146,28,2378
"047","Pistoia",46,495,1717,110,10,2332,396,1760,138,30,2324
"047","Pistoia",47,454,1831,99,9,2393,351,1875,157,36,2419
"047","Pistoia",48,366,1677,114,8,2165,342,1769,147,47,2305
"047","Pistoia",49,346,1703,123,19,2191,283,1700,139,54,2176
"047","Pistoia",50,325,1716,88,13,2142,259,1760,164,69,2252
"047","Pistoia",51,290,1636,119,17,2062,254,1745,145,68,2212
"047","Pistoia",52,279,1601,105,14,1999,261,1621,148,71,2101
"047","Pistoia",53,246,1587,92,19,1944,238,1549,134,88,2009
"047","Pistoia",54,209,1501,88,19,1817,227,1567,134,89,2017
"047","Pistoia",55,184,1524,86,20,1814,185,1492,123,99,1899
"047","Pistoia",56,186,1508,94,37,1825,214,1496,117,116,1943
"047","Pistoia",57,180,1460,74,33,1747,182,1444,115,110,1851
"047","Pistoia",58,163,1398,74,35,1670,166,1389,99,136,1790
"047","Pistoia",59,148,1410,76,29,1663,154,1459,124,120,1857
"047","Pistoia",60,161,1529,75,34,1799,140,1415,92,152,1799
"047","Pistoia",61,132,1449,83,58,1722,136,1398,88,182,1804
"047","Pistoia",62,153,1452,81,45,1731,136,1507,77,195,1915
"047","Pistoia",63,158,1607,80,49,1894,133,1583,96,229,2041
"047","Pistoia",64,133,1659,69,62,1923,122,1578,105,272,2077
"047","Pistoia",65,140,1611,44,76,1871,130,1607,73,297,2107
"047","Pistoia",66,91,1312,40,63,1506,84,1239,59,287,1669
"047","Pistoia",67,104,1243,48,61,1456,85,1197,62,326,1670
"047","Pistoia",68,110,1318,37,74,1539,90,1219,60,317,1686
"047","Pistoia",69,116,1178,44,82,1420,85,1101,43,356,1585
"047","Pistoia",70,102,1192,39,65,1398,82,1168,49,394,1693
"047","Pistoia",71,111,1281,38,90,1520,109,1194,45,485,1833
"047","Pistoia",72,128,1309,38,113,1588,90,1096,43,554,1783
"047","Pistoia",73,91,1283,28,122,1524,90,1084,36,555,1765
"047","Pistoia",74,100,1210,31,117,1458,92,1013,36,606,1747
"047","Pistoia",75,85,1085,17,126,1313,106,880,24,648,1658
"047","Pistoia",76,100,1064,17,129,1310,81,828,24,685,1618
"047","Pistoia",77,84,963,24,119,1190,72,678,21,714,1485
"047","Pistoia",78,73,822,11,134,1040,71,617,23,730,1441
"047","Pistoia",79,86,837,8,130,1061,83,550,16,807,1456
"047","Pistoia",80,67,788,7,120,982,98,485,18,707,1308
"047","Pistoia",81,66,724,11,149,950,97,456,22,858,1433
"047","Pistoia",82,50,617,6,155,828,56,377,18,779,1230
"047","Pistoia",83,55,523,5,137,720,85,338,12,837,1272
"047","Pistoia",84,28,478,7,138,651,67,220,13,825,1125
"047","Pistoia",85,45,415,3,128,591,80,205,9,739,1033
"047","Pistoia",86,36,335,4,126,501,75,163,14,801,1053
"047","Pistoia",87,31,303,3,133,470,65,131,3,687,886
"047","Pistoia",88,21,253,2,144,420,55,98,7,657,817
"047","Pistoia",89,9,162,3,114,288,44,66,5,649,764
"047","Pistoia",90,10,164,0,98,272,35,54,3,592,684
"047","Pistoia",91,13,125,1,99,238,30,40,3,499,572
"047","Pistoia",92,7,51,0,49,107,23,16,2,274,315
"047","Pistoia",93,3,29,0,30,62,15,3,0,167,185
"047","Pistoia",94,4,18,0,32,54,14,8,1,127,150
"047","Pistoia",95,3,12,1,29,45,13,0,0,135,148
"047","Pistoia",96,3,17,0,25,45,9,3,0,127,139
"047","Pistoia",97,4,15,0,18,37,2,4,1,110,117
"047","Pistoia",98,1,3,0,17,21,5,1,1,65,72
"047","Pistoia",99,0,7,0,6,13,6,0,1,52,59
"047","Pistoia",100,2,2,0,6,10,9,1,0,70,80
"048","Firenze",0,4148,0,0,0,4148,3824,0,0,0,3824
"048","Firenze",1,4395,0,0,0,4395,4107,0,0,0,4107
"048","Firenze",2,4393,0,0,0,4393,4197,0,0,0,4197
"048","Firenze",3,4644,0,0,0,4644,4149,0,0,0,4149
"048","Firenze",4,4579,0,0,0,4579,4207,0,0,0,4207
"048","Firenze",5,4407,0,0,0,4407,4266,0,0,0,4266
"048","Firenze",6,4471,0,0,0,4471,4375,0,0,0,4375
"048","Firenze",7,4614,0,0,0,4614,4187,0,0,0,4187
"048","Firenze",8,4488,0,0,0,4488,4177,0,0,0,4177
"048","Firenze",9,4420,0,0,0,4420,4262,0,0,0,4262
"048","Firenze",10,4371,0,0,0,4371,4167,0,0,0,4167
"048","Firenze",11,4421,0,0,0,4421,4108,0,0,0,4108
"048","Firenze",12,4235,0,0,0,4235,3892,0,0,0,3892
"048","Firenze",13,4278,0,0,0,4278,3962,0,0,0,3962
"048","Firenze",14,4230,0,0,0,4230,3948,0,0,0,3948
"048","Firenze",15,4017,0,0,0,4017,3811,0,0,0,3811
"048","Firenze",16,4025,0,0,0,4025,3869,0,0,0,3869
"048","Firenze",17,3934,0,0,0,3934,3884,1,0,0,3885
"048","Firenze",18,4071,1,0,0,4072,3678,4,0,0,3682
"048","Firenze",19,4176,4,0,0,4180,4010,30,0,0,4040
"048","Firenze",20,4103,9,0,0,4112,3905,71,0,0,3976
"048","Firenze",21,4301,11,0,0,4312,3930,132,0,0,4062
"048","Firenze",22,4234,35,0,0,4269,3935,215,0,0,4150
"048","Firenze",23,4327,58,0,0,4385,3983,286,2,0,4271
"048","Firenze",24,4267,111,0,0,4378,3738,426,1,0,4165
"048","Firenze",25,3974,150,0,0,4124,3789,527,7,0,4323
"048","Firenze",26,4245,253,1,0,4499,3828,745,5,1,4579
"048","Firenze",27,4168,348,2,0,4518,3778,913,9,3,4703
"048","Firenze",28,4170,551,2,0,4723,3768,1202,12,3,4985
"048","Firenze",29,4210,712,5,0,4927,3482,1453,19,2,4956
"048","Firenze",30,3995,1002,8,0,5005,3388,1768,34,1,5191
"048","Firenze",31,3981,1190,8,0,5179,3295,2008,45,7,5355
"048","Firenze",32,3927,1571,15,1,5514,3293,2326,61,7,5687
"048","Firenze",33,3967,1911,27,0,5905,3342,2743,70,13,6168
"048","Firenze",34,3842,2260,40,1,6143,3121,3102,88,10,6321
"048","Firenze",35,4079,2534,40,5,6658,3172,3542,108,13,6835
"048","Firenze",36,3986,2864,64,3,6917,3238,3821,138,20,7217
"048","Firenze",37,3894,3466,87,7,7454,3276,4259,193,23,7751
"048","Firenze",38,3767,3590,111,6,7474,3177,4452,236,23,7888
"048","Firenze",39,3632,3901,115,5,7653,2929,4688,259,39,7915
"048","Firenze",40,3426,4185,114,6,7731,2782,4989,292,34,8097
"048","Firenze",41,3227,4393,178,8,7806,2504,4951,319,47,7821
"048","Firenze",42,3083,4560,188,7,7838,2525,5080,361,54,8020
"048","Firenze",43,2879,4621,243,17,7760,2363,5269,388,59,8079
"048","Firenze",44,2721,4886,251,14,7872,2317,5463,417,70,8267
"048","Firenze",45,2615,5228,304,17,8164,2166,5548,427,101,8242
"048","Firenze",46,2338,5326,305,23,7992,2069,5662,490,86,8307
"048","Firenze",47,2232,5367,329,37,7965,1972,5633,532,118,8255
"048","Firenze",48,1930,5121,302,26,7379,1698,5350,491,107,7646
"048","Firenze",49,1747,5064,381,19,7211,1615,5212,492,146,7465
"048","Firenze",50,1591,4890,351,45,6877,1444,5051,477,144,7116
"048","Firenze",51,1425,4964,378,47,6814,1366,5137,495,146,7144
"048","Firenze",52,1318,4954,372,46,6690,1237,5115,500,186,7038
"048","Firenze",53,1194,4714,310,53,6271,1188,4925,525,195,6833
"048","Firenze",54,1059,4640,330,68,6097,1205,4741,507,230,6683
"048","Firenze",55,1024,4489,332,72,5917,1071,4798,512,240,6621
"048","Firenze",56,956,4459,333,72,5820,1062,4686,460,272,6480
"048","Firenze",57,861,4474,342,75,5752,909,4867,457,324,6557
"048","Firenze",58,815,4461,319,83,5678,864,4313,453,354,5984
"048","Firenze",59,717,4471,282,80,5550,828,4630,417,367,6242
"048","Firenze",60,696,4504,309,119,5628,764,4580,414,438,6196
"048","Firenze",61,676,4589,275,128,5668,720,4697,418,536,6371
"048","Firenze",62,683,4881,271,134,5969,743,4925,439,618,6725
"048","Firenze",63,628,5261,291,164,6344,717,5222,472,741,7152
"048","Firenze",64,662,5215,241,202,6320,722,5274,435,793,7224
"048","Firenze",65,640,5361,266,214,6481,650,5283,417,889,7239
"048","Firenze",66,439,4265,194,189,5087,466,4191,329,772,5758
"048","Firenze",67,417,4220,208,211,5056,457,4061,296,838,5652
"048","Firenze",68,424,4320,188,243,5175,437,4219,314,1029,5999
"048","Firenze",69,371,4008,188,209,4776,403,3776,279,1095,5553
"048","Firenze",70,417,4069,168,251,4905,412,4061,287,1188,5948
"048","Firenze",71,400,4635,192,344,5571,438,4288,309,1541,6576
"048","Firenze",72,426,4414,152,426,5418,393,4253,277,1653,6576
"048","Firenze",73,363,4511,135,405,5414,442,4068,237,1783,6530
"048","Firenze",74,342,3829,119,420,4710,381,3469,206,1772,5828
"048","Firenze",75,313,3417,86,386,4202,409,3070,170,1786,5435
"048","Firenze",76,313,3584,108,404,4409,312,3057,174,2012,5555
"048","Firenze",77,282,3222,85,368,3957,328,2717,155,2049,5249
"048","Firenze",78,269,3035,58,461,3823,312,2462,132,2242,5148
"048","Firenze",79,260,2764,59,421,3504,319,2176,110,2322,4927
"048","Firenze",80,246,2758,62,462,3528,342,2026,108,2527,5003
"048","Firenze",81,248,2674,46,484,3452,324,1799,105,2767,4995
"048","Firenze",82,183,2337,41,491,3052,337,1521,97,2578,4533
"048","Firenze",83,164,2027,43,539,2773,349,1255,67,2699,4370
"048","Firenze",84,136,1795,18,497,2446,269,1075,56,2784,4184
"048","Firenze",85,129,1527,14,513,2183,318,931,51,2615,3915
"048","Firenze",86,109,1329,22,461,1921,257,743,54,2591,3645
"048","Firenze",87,107,1137,12,475,1731,256,579,55,2468,3358
"048","Firenze",88,75,928,18,474,1495,222,420,34,2365,3041
"048","Firenze",89,65,741,7,387,1200,226,333,26,2184,2769
"048","Firenze",90,54,602,11,381,1048,199,214,20,1948,2381
"048","Firenze",91,36,437,10,329,812,178,160,18,1789,2145
"048","Firenze",92,18,217,2,190,427,83,75,15,949,1122
"048","Firenze",93,14,93,3,91,201,54,26,6,572,658
"048","Firenze",94,5,84,2,77,168,37,23,6,457,523
"048","Firenze",95,7,59,1,69,136,40,17,3,488,548
"048","Firenze",96,8,45,1,93,147,43,11,2,488,544
"048","Firenze",97,7,34,0,83,124,34,17,2,398,451
"048","Firenze",98,1,32,2,44,79,33,6,1,247,287
"048","Firenze",99,3,13,0,33,49,26,1,2,171,200
"048","Firenze",100,0,3,0,48,51,44,4,10,256,314
"049","Livorno",0,1331,0,0,0,1331,1281,0,0,0,1281
"049","Livorno",1,1404,0,0,0,1404,1328,0,0,0,1328
"049","Livorno",2,1441,0,0,0,1441,1362,0,0,0,1362
"049","Livorno",3,1393,0,0,0,1393,1353,0,0,0,1353
"049","Livorno",4,1489,0,0,0,1489,1386,0,0,0,1386
"049","Livorno",5,1444,0,0,0,1444,1369,0,0,0,1369
"049","Livorno",6,1389,0,0,0,1389,1293,0,0,0,1293
"049","Livorno",7,1475,0,0,0,1475,1335,0,0,0,1335
"049","Livorno",8,1351,0,0,0,1351,1312,0,0,0,1312
"049","Livorno",9,1353,0,0,0,1353,1295,0,0,0,1295
"049","Livorno",10,1355,0,0,0,1355,1355,0,0,0,1355
"049","Livorno",11,1350,0,0,0,1350,1284,0,0,0,1284
"049","Livorno",12,1346,0,0,0,1346,1216,0,0,0,1216
"049","Livorno",13,1305,0,0,0,1305,1274,0,0,0,1274
"049","Livorno",14,1383,0,0,0,1383,1282,0,0,0,1282
"049","Livorno",15,1318,0,0,0,1318,1239,0,0,0,1239
"049","Livorno",16,1342,0,0,0,1342,1318,0,0,0,1318
"049","Livorno",17,1338,0,0,0,1338,1287,0,0,0,1287
"049","Livorno",18,1336,0,0,0,1336,1198,5,0,0,1203
"049","Livorno",19,1455,0,0,0,1455,1284,32,0,0,1316
"049","Livorno",20,1410,0,0,0,1410,1278,36,0,0,1314
"049","Livorno",21,1481,15,4,0,1500,1310,52,0,0,1362
"049","Livorno",22,1422,24,6,0,1452,1304,97,0,0,1401
"049","Livorno",23,1448,40,9,0,1497,1304,134,0,0,1438
"049","Livorno",24,1336,44,12,0,1392,1298,163,1,0,1462
"049","Livorno",25,1335,92,20,0,1447,1175,243,11,10,1439
"049","Livorno",26,1458,127,23,0,1608,1211,306,3,11,1531
"049","Livorno",27,1316,161,14,8,1499,1149,393,9,6,1557
"049","Livorno",28,1351,241,16,0,1608,1078,477,16,8,1579
"049","Livorno",29,1446,330,19,0,1795,1091,580,21,0,1692
"049","Livorno",30,1278,377,21,12,1688,1039,694,24,1,1758
"049","Livorno",31,1305,521,26,0,1852,1029,794,36,4,1863
"049","Livorno",32,1339,625,23,0,1987,1023,945,31,6,2005
"049","Livorno",33,1403,699,27,1,2130,1013,1062,43,6,2124
"049","Livorno",34,1276,887,25,0,2188,988,1162,49,13,2212
"049","Livorno",35,1270,966,37,1,2274,932,1245,58,18,2253
"049","Livorno",36,1259,1138,48,9,2454,964,1443,90,12,2509
"049","Livorno",37,1274,1311,43,17,2645,855,1560,92,16,2523
"049","Livorno",38,1139,1397,62,11,2609,851,1725,127,17,2720
"049","Livorno",39,1087,1454,80,14,2635,787,1848,140,26,2801
"049","Livorno",40,1017,1602,85,15,2719,688,1765,157,27,2637
"049","Livorno",41,919,1640,111,10,2680,624,1850,162,32,2668
"049","Livorno",42,828,1774,124,4,2730,552,1975,184,36,2747
"049","Livorno",43,792,1688,120,14,2614,563,1943,205,43,2754
"049","Livorno",44,713,1836,129,13,2691,498,2010,216,46,2770
"049","Livorno",45,629,1880,162,10,2681,507,2091,207,53,2858
"049","Livorno",46,598,1937,153,20,2708,448,2089,249,50,2836
"049","Livorno",47,556,2076,194,26,2852,430,2119,256,61,2866
"049","Livorno",48,462,1958,197,21,2638,379,2023,265,66,2733
"049","Livorno",49,459,1917,176,10,2562,323,1933,228,86,2570
"049","Livorno",50,364,1939,181,14,2498,342,1982,213,85,2622
"049","Livorno",51,336,1800,166,19,2321,297,1865,193,93,2448
"049","Livorno",52,303,1723,154,16,2196,269,1787,211,106,2373
"049","Livorno",53,306,1657,118,26,2107,217,1792,225,111,2345
"049","Livorno",54,235,1790,162,30,2217,217,1803,205,116,2341
"049","Livorno",55,236,1784,137,31,2188,204,1820,181,140,2345
"049","Livorno",56,231,1766,127,28,2152,178,1820,184,153,2335
"049","Livorno",57,200,1608,116,35,1959,165,1811,167,168,2311
"049","Livorno",58,177,1656,105,29,1967,153,1679,164,155,2151
"049","Livorno",59,176,1656,98,41,1971,131,1681,133,187,2132
"049","Livorno",60,167,1651,83,32,1933,141,1650,112,196,2099
"049","Livorno",61,146,1705,109,53,2013,131,1710,118,219,2178
"049","Livorno",62,149,1858,96,61,2164,152,1815,133,251,2351
"049","Livorno",63,128,1996,84,77,2285,114,1996,133,277,2520
"049","Livorno",64,148,1986,101,83,2318,103,2043,133,336,2615
"049","Livorno",65,115,2169,102,89,2475,129,2195,134,421,2879
"049","Livorno",66,119,1745,61,79,2004,91,1684,106,355,2236
"049","Livorno",67,97,1695,78,94,1964,93,1655,76,390,2214
"049","Livorno",68,77,1589,60,96,1822,90,1522,76,397,2085
"049","Livorno",69,95,1634,53,91,1873,95,1520,78,433,2126
"049","Livorno",70,98,1565,50,98,1811,109,1485,65,535,2194
"049","Livorno",71,123,1718,50,126,2017,108,1543,71,642,2364
"049","Livorno",72,101,1678,32,126,1937,112,1435,69,678,2294
"049","Livorno",73,91,1704,37,171,2003,81,1418,52,721,2272
"049","Livorno",74,85,1478,31,119,1713,76,1196,51,743,2066
"049","Livorno",75,78,1230,25,145,1478,92,1063,39,752,1946
"049","Livorno",76,68,1237,23,161,1489,86,971,35,804,1896
"049","Livorno",77,74,1097,28,176,1375,100,839,27,836,1802
"049","Livorno",78,76,1079,25,159,1339,85,761,37,853,1736
"049","Livorno",79,58,1064,17,162,1301,79,693,23,936,1731
"049","Livorno",80,59,980,15,188,1242,86,628,27,1049,1790
"049","Livorno",81,49,910,12,205,1176,104,535,17,1092,1748
"049","Livorno",82,44,792,7,187,1030,98,433,14,1072,1617
"049","Livorno",83,30,699,12,199,940,90,368,17,1050,1525
"049","Livorno",84,36,597,10,183,826,90,307,12,1010,1419
"049","Livorno",85,30,486,9,179,704,78,285,17,969,1349
"049","Livorno",86,27,433,6,204,670,66,225,13,939,1243
"049","Livorno",87,24,368,7,187,586,72,149,22,884,1127
"049","Livorno",88,19,268,2,169,458,64,123,15,823,1025
"049","Livorno",89,12,243,1,143,399,50,94,15,722,881
"049","Livorno",90,8,188,2,152,350,52,58,11,686,807
"049","Livorno",91,7,172,1,126,306,49,40,10,544,643
"049","Livorno",92,5,70,1,73,149,20,13,3,289,325
"049","Livorno",93,2,34,0,44,80,17,9,1,203,230
"049","Livorno",94,4,28,0,36,68,11,6,0,153,170
"049","Livorno",95,2,23,0,29,54,10,2,2,157,171
"049","Livorno",96,4,16,0,29,49,6,3,1,155,165
"049","Livorno",97,0,9,0,31,40,12,4,2,96,114
"049","Livorno",98,0,4,0,15,19,7,0,1,75,83
"049","Livorno",99,0,4,0,15,19,5,1,0,49,55
"049","Livorno",100,0,2,0,13,15,6,2,0,85,93
"050","Pisa",0,1837,0,0,0,1837,1818,0,0,0,1818
"050","Pisa",1,1924,0,0,0,1924,1901,0,0,0,1901
"050","Pisa",2,1976,0,0,0,1976,1852,0,0,0,1852
"050","Pisa",3,1950,0,0,0,1950,1884,0,0,0,1884
"050","Pisa",4,1966,0,0,0,1966,1856,0,0,0,1856
"050","Pisa",5,1856,0,0,0,1856,1772,0,0,0,1772
"050","Pisa",6,1930,0,0,0,1930,1730,0,0,0,1730
"050","Pisa",7,1874,0,0,0,1874,1738,0,0,0,1738
"050","Pisa",8,1792,0,0,0,1792,1672,0,0,0,1672
"050","Pisa",9,1808,0,0,0,1808,1671,0,0,0,1671
"050","Pisa",10,1772,0,0,0,1772,1640,0,0,0,1640
"050","Pisa",11,1787,0,0,0,1787,1719,0,0,0,1719
"050","Pisa",12,1759,0,0,0,1759,1651,0,0,0,1651
"050","Pisa",13,1733,0,0,0,1733,1538,0,0,0,1538
"050","Pisa",14,1721,0,0,0,1721,1609,0,0,0,1609
"050","Pisa",15,1611,0,0,0,1611,1574,0,0,0,1574
"050","Pisa",16,1665,0,0,0,1665,1588,0,0,0,1588
"050","Pisa",17,1672,0,0,0,1672,1557,2,0,0,1559
"050","Pisa",18,1715,1,0,0,1716,1602,7,0,0,1609
"050","Pisa",19,1815,1,0,0,1816,1686,19,0,0,1705
"050","Pisa",20,1841,2,0,0,1843,1628,52,1,0,1681
"050","Pisa",21,1852,6,0,0,1858,1754,91,1,0,1846
"050","Pisa",22,1849,19,0,0,1868,1681,127,1,0,1809
"050","Pisa",23,1869,31,1,0,1901,1695,200,0,1,1896
"050","Pisa",24,1836,51,1,0,1888,1537,229,3,2,1771
"050","Pisa",25,1800,106,1,0,1907,1631,323,0,2,1956
"050","Pisa",26,1868,133,4,0,2005,1651,418,2,0,2071
"050","Pisa",27,1937,210,1,0,2148,1616,491,8,0,2115
"050","Pisa",28,1843,332,4,0,2179,1621,694,3,0,2318
"050","Pisa",29,1967,449,4,0,2420,1462,829,8,0,2299
"050","Pisa",30,1908,645,5,0,2558,1392,972,6,2,2372
"050","Pisa",31,1792,773,5,0,2570,1386,1125,17,4,2532
"050","Pisa",32,1803,944,12,1,2760,1279,1346,21,7,2653
"050","Pisa",33,1792,1067,11,2,2872,1245,1615,38,2,2900
"050","Pisa",34,1770,1278,16,0,3064,1243,1607,48,5,2903
"050","Pisa",35,1665,1422,28,0,3115,1199,1899,44,13,3155
"050","Pisa",36,1602,1571,32,2,3207,1107,1973,75,14,3169
"050","Pisa",37,1652,1777,40,1,3470,1163,2331,91,16,3601
"050","Pisa",38,1376,2045,50,6,3477,994,2246,93,17,3350
"050","Pisa",39,1345,2169,63,3,3580,924,2257,133,16,3330
"050","Pisa",40,1189,2209,62,4,3464,872,2441,118,16,3447
"050","Pisa",41,1147,2054,90,5,3296,762,2243,132,23,3160
"050","Pisa",42,1008,2296,99,5,3408,674,2437,172,30,3313
"050","Pisa",43,901,2267,105,3,3276,675,2391,157,35,3258
"050","Pisa",44,810,2322,126,10,3268,594,2477,182,51,3304
"050","Pisa",45,746,2423,116,10,3295,543,2524,201,44,3312
"050","Pisa",46,790,2411,149,7,3357,538,2503,200,50,3291
"050","Pisa",47,639,2450,175,10,3274,501,2662,192,46,3401
"050","Pisa",48,576,2364,129,25,3094,451,2493,202,53,3199
"050","Pisa",49,498,2243,155,19,2915,397,2538,174,73,3182
"050","Pisa",50,474,2301,136,18,2929,368,2468,195,95,3126
"050","Pisa",51,423,2319,124,21,2887,351,2332,198,92,2973
"050","Pisa",52,387,2326,157,29,2899,300,2272,152,105,2829
"050","Pisa",53,338,2196,139,17,2690,303,2237,169,112,2821
"050","Pisa",54,328,2142,106,34,2610,307,2121,163,136,2727
"050","Pisa",55,282,2173,103,42,2600,255,2209,142,134,2740
"050","Pisa",56,290,2078,109,45,2522,254,2136,154,131,2675
"050","Pisa",57,240,2066,115,43,2464,202,2197,145,167,2711
"050","Pisa",58,228,2044,112,48,2432,209,2013,129,160,2511
"050","Pisa",59,199,1942,90,47,2278,183,2021,126,185,2515
"050","Pisa",60,176,1999,90,55,2320,159,1960,117,200,2436
"050","Pisa",61,195,2069,97,60,2421,191,2182,132,228,2733
"050","Pisa",62,175,2190,104,82,2551,182,2179,138,300,2799
"050","Pisa",63,194,2316,85,96,2691,158,2346,122,327,2953
"050","Pisa",64,159,2346,85,96,2686,156,2350,123,362,2991
"050","Pisa",65,170,2438,85,93,2786,171,2372,130,444,3117
"050","Pisa",66,140,1915,61,89,2205,121,1829,84,399,2433
"050","Pisa",67,117,1790,62,76,2045,129,1726,76,423,2354
"050","Pisa",68,111,1850,55,94,2110,103,1707,74,529,2413
"050","Pisa",69,123,1714,42,121,2000,109,1680,54,506,2349
"050","Pisa",70,124,1658,48,133,1963,103,1567,51,580,2301
"050","Pisa",71,136,1918,33,133,2220,114,1691,59,699,2563
"050","Pisa",72,143,1870,34,130,2177,105,1681,45,768,2599
"050","Pisa",73,114,1878,24,179,2195,102,1660,44,838,2644
"050","Pisa",74,111,1646,34,173,1964,111,1374,40,862,2387
"050","Pisa",75,117,1482,30,163,1792,106,1162,26,842,2136
"050","Pisa",76,116,1533,20,186,1855,91,1106,23,938,2158
"050","Pisa",77,111,1347,12,198,1668,88,947,32,991,2058
"050","Pisa",78,90,1243,18,200,1551,94,885,27,998,2004
"050","Pisa",79,91,1103,13,179,1386,85,776,22,1081,1964
"050","Pisa",80,66,1095,10,214,1385,93,677,15,1137,1922
"050","Pisa",81,90,1027,16,203,1336,115,657,18,1184,1974
"050","Pisa",82,62,823,3,213,1101,104,530,20,1198,1852
"050","Pisa",83,67,766,11,221,1065,100,451,16,1144,1711
"050","Pisa",84,48,741,2,203,994,101,344,11,1180,1636
"050","Pisa",85,51,534,3,208,796,88,261,20,1073,1442
"050","Pisa",86,25,486,5,197,713,95,245,13,1080,1433
"050","Pisa",87,28,381,3,203,615,74,197,4,948,1223
"050","Pisa",88,21,317,2,174,514,84,135,7,950,1176
"050","Pisa",89,17,234,1,167,419,77,89,6,822,994
"050","Pisa",90,17,198,1,149,365,70,74,11,773,928
"050","Pisa",91,11,155,0,146,312,53,38,4,645,740
"050","Pisa",92,8,66,0,87,161,27,25,4,362,418
"050","Pisa",93,2,32,0,41,75,18,10,0,194,222
"050","Pisa",94,2,16,0,29,47,7,8,0,154,169
"050","Pisa",95,1,20,0,24,45,7,5,0,133,145
"050","Pisa",96,2,19,0,33,54,10,3,3,144,160
"050","Pisa",97,1,13,0,23,37,8,2,0,129,139
"050","Pisa",98,0,5,0,16,21,4,2,0,96,102
"050","Pisa",99,1,3,0,7,11,6,1,0,57,64
"050","Pisa",100,0,2,0,11,13,8,0,1,91,100
"051","Arezzo",0,1444,0,0,0,1444,1461,0,0,0,1461
"051","Arezzo",1,1515,0,0,0,1515,1435,0,0,0,1435
"051","Arezzo",2,1568,0,0,0,1568,1431,0,0,0,1431
"051","Arezzo",3,1562,0,0,0,1562,1488,0,0,0,1488
"051","Arezzo",4,1594,0,0,0,1594,1482,0,0,0,1482
"051","Arezzo",5,1525,0,0,0,1525,1482,0,0,0,1482
"051","Arezzo",6,1506,0,0,0,1506,1484,0,0,0,1484
"051","Arezzo",7,1571,0,0,0,1571,1525,0,0,0,1525
"051","Arezzo",8,1485,0,0,0,1485,1418,0,0,0,1418
"051","Arezzo",9,1499,0,0,0,1499,1439,0,0,0,1439
"051","Arezzo",10,1496,0,0,0,1496,1445,0,0,0,1445
"051","Arezzo",11,1482,0,0,0,1482,1443,0,0,0,1443
"051","Arezzo",12,1489,0,0,0,1489,1359,0,0,0,1359
"051","Arezzo",13,1524,0,0,0,1524,1350,0,0,0,1350
"051","Arezzo",14,1470,0,0,0,1470,1397,0,0,0,1397
"051","Arezzo",15,1522,0,0,0,1522,1424,0,0,0,1424
"051","Arezzo",16,1401,0,0,0,1401,1360,0,0,0,1360
"051","Arezzo",17,1514,0,0,0,1514,1408,1,0,0,1409
"051","Arezzo",18,1532,0,0,0,1532,1383,7,0,0,1390
"051","Arezzo",19,1594,2,0,0,1596,1454,42,0,0,1496
"051","Arezzo",20,1571,23,21,0,1615,1409,52,0,0,1461
"051","Arezzo",21,1601,26,16,0,1643,1496,116,0,0,1612
"051","Arezzo",22,1537,53,30,0,1620,1476,125,0,0,1601
"051","Arezzo",23,1665,62,27,0,1754,1484,155,25,0,1664
"051","Arezzo",24,1678,108,34,0,1820,1480,280,11,0,1771
"051","Arezzo",25,1537,125,39,0,1701,1393,319,26,1,1739
"051","Arezzo",26,1596,149,28,0,1773,1451,421,30,0,1902
"051","Arezzo",27,1547,241,40,0,1828,1349,501,28,22,1900
"051","Arezzo",28,1595,331,40,1,1967,1199,646,29,10,1884
"051","Arezzo",29,1521,380,40,0,1941,1149,749,34,11,1943
"051","Arezzo",30,1434,481,37,0,1952,1064,864,38,13,1979
"051","Arezzo",31,1389,658,51,0,2098,988,984,45,12,2029
"051","Arezzo",32,1280,811,38,1,2130,941,1194,49,23,2207
"051","Arezzo",33,1331,898,45,0,2274,934,1220,64,11,2229
"051","Arezzo",34,1162,1030,45,1,2238,884,1394,67,21,2366
"051","Arezzo",35,1249,1230,56,0,2535,815,1536,67,23,2441
"051","Arezzo",36,1162,1245,48,22,2477,790,1696,100,23,2609
"051","Arezzo",37,1085,1466,61,21,2633,743,1761,94,30,2628
"051","Arezzo",38,953,1625,54,10,2642,676,1883,119,29,2707
"051","Arezzo",39,917,1670,75,23,2685,667,1868,110,34,2679
"051","Arezzo",40,871,1743,87,17,2718,608,1927,112,33,2680
"051","Arezzo",41,784,1786,93,18,2681,551,1934,126,32,2643
"051","Arezzo",42,726,1887,96,11,2720,529,2108,128,38,2803
"051","Arezzo",43,673,1835,78,20,2606,525,2097,157,45,2824
"051","Arezzo",44,639,1945,113,13,2710,464,2093,173,52,2782
"051","Arezzo",45,652,2016,107,19,2794,444,2090,163,60,2757
"051","Arezzo",46,573,2077,116,21,2787,414,2200,164,56,2834
"051","Arezzo",47,518,2100,139,22,2779,381,2087,174,60,2702
"051","Arezzo",48,465,1935,132,16,2548,310,2084,156,68,2618
"051","Arezzo",49,405,1952,111,25,2493,274,2057,176,70,2577
"051","Arezzo",50,366,2005,117,23,2511,275,2035,167,94,2571
"051","Arezzo",51,328,1949,109,25,2411,237,2026,151,95,2509
"051","Arezzo",52,309,1956,96,27,2388,252,1902,151,103,2408
"051","Arezzo",53,284,1835,105,23,2247,254,1874,129,101,2358
"051","Arezzo",54,255,1874,100,25,2254,195,1867,117,99,2278
"051","Arezzo",55,264,1794,97,27,2182,214,1848,114,148,2324
"051","Arezzo",56,237,1759,82,29,2107,193,1772,131,126,2222
"051","Arezzo",57,225,1821,87,47,2180,181,1836,131,140,2288
"051","Arezzo",58,194,1684,71,35,1984,171,1722,105,156,2154
"051","Arezzo",59,208,1705,83,44,2040,150,1644,93,139,2026
"051","Arezzo",60,224,1788,74,45,2131,142,1838,84,195,2259
"051","Arezzo",61,192,1773,68,68,2101,149,1758,95,214,2216
"051","Arezzo",62,187,1897,55,57,2196,134,1905,91,249,2379
"051","Arezzo",63,202,2078,75,64,2419,141,2055,85,289,2570
"051","Arezzo",64,186,1972,68,67,2293,123,1907,83,310,2423
"051","Arezzo",65,164,1923,47,87,2221,123,1772,88,324,2307
"051","Arezzo",66,136,1576,47,74,1833,90,1429,56,286,1861
"051","Arezzo",67,110,1405,27,80,1622,83,1282,45,323,1733
"051","Arezzo",68,144,1518,47,86,1795,107,1409,41,374,1931
"051","Arezzo",69,120,1393,39,74,1626,111,1262,40,368,1781
"051","Arezzo",70,143,1436,29,83,1691,96,1260,38,440,1834
"051","Arezzo",71,146,1556,43,131,1876,113,1397,48,610,2168
"051","Arezzo",72,148,1448,36,132,1764,110,1312,37,575,2034
"051","Arezzo",73,142,1520,28,136,1826,95,1320,37,702,2154
"051","Arezzo",74,148,1315,24,118,1605,106,1172,24,669,1971
"051","Arezzo",75,160,1242,18,140,1560,87,969,19,660,1735
"051","Arezzo",76,117,1288,15,183,1603,69,999,24,793,1885
"051","Arezzo",77,117,1125,15,148,1405,74,849,20,780,1723
"051","Arezzo",78,127,1126,9,153,1415,81,744,15,826,1666
"051","Arezzo",79,94,901,8,148,1151,75,653,11,809,1548
"051","Arezzo",80,114,977,11,183,1285,82,632,13,992,1719
"051","Arezzo",81,98,880,7,191,1176,87,588,12,1052,1739
"051","Arezzo",82,84,760,3,175,1022,65,458,3,949,1475
"051","Arezzo",83,75,672,4,176,927,84,386,8,1005,1483
"051","Arezzo",84,62,633,7,206,908,77,347,10,1066,1500
"051","Arezzo",85,55,530,5,197,787,70,251,9,986,1316
"051","Arezzo",86,50,444,3,209,706,61,215,8,969,1253
"051","Arezzo",87,43,388,3,172,606,49,197,6,882,1134
"051","Arezzo",88,38,299,2,140,479,52,143,5,858,1058
"051","Arezzo",89,23,237,1,155,416,63,91,3,716,873
"051","Arezzo",90,23,186,3,152,364,54,60,2,681,797
"051","Arezzo",91,14,121,2,101,238,31,44,3,537,615
"051","Arezzo",92,6,72,1,59,138,21,23,1,323,368
"051","Arezzo",93,5,34,1,39,79,10,9,0,194,213
"051","Arezzo",94,1,31,0,40,72,10,12,1,141,164
"051","Arezzo",95,1,14,1,46,62,10,6,0,153,169
"051","Arezzo",96,3,14,0,27,44,13,6,0,133,152
"051","Arezzo",97,3,10,1,23,37,13,4,1,109,127
"051","Arezzo",98,0,6,0,22,28,4,3,0,75,82
"051","Arezzo",99,0,6,0,19,25,3,5,0,56,64
"051","Arezzo",100,3,4,0,13,20,6,3,0,70,79
"052","Siena",0,1179,0,0,0,1179,1104,0,0,0,1104
"052","Siena",1,1206,0,0,0,1206,1175,0,0,0,1175
"052","Siena",2,1199,0,0,0,1199,1183,0,0,0,1183
"052","Siena",3,1206,0,0,0,1206,1121,0,0,0,1121
"052","Siena",4,1197,0,0,0,1197,1189,0,0,0,1189
"052","Siena",5,1170,0,0,0,1170,1107,0,0,0,1107
"052","Siena",6,1236,0,0,0,1236,1059,0,0,0,1059
"052","Siena",7,1156,0,0,0,1156,1088,0,0,0,1088
"052","Siena",8,1148,0,0,0,1148,1076,0,0,0,1076
"052","Siena",9,1094,0,0,0,1094,1047,0,0,0,1047
"052","Siena",10,1128,0,0,0,1128,1078,0,0,0,1078
"052","Siena",11,1143,0,0,0,1143,1139,0,0,0,1139
"052","Siena",12,1127,0,0,0,1127,1037,0,0,0,1037
"052","Siena",13,1091,0,0,0,1091,997,0,0,0,997
"052","Siena",14,1083,0,0,0,1083,1026,0,0,0,1026
"052","Siena",15,1141,0,0,0,1141,1068,0,0,0,1068
"052","Siena",16,1095,0,0,0,1095,994,0,0,0,994
"052","Siena",17,1108,0,0,0,1108,1026,0,0,0,1026
"052","Siena",18,1106,0,0,0,1106,1036,15,0,0,1051
"052","Siena",19,1163,1,0,0,1164,1090,26,0,0,1116
"052","Siena",20,1123,11,9,0,1143,1017,57,1,0,1075
"052","Siena",21,1198,16,0,0,1214,1062,101,0,0,1163
"052","Siena",22,1211,19,0,0,1230,1005,107,1,0,1113
"052","Siena",23,1187,53,10,0,1250,1049,174,1,0,1224
"052","Siena",24,1119,60,9,0,1188,1014,193,0,0,1207
"052","Siena",25,1155,86,14,0,1255,988,254,2,1,1245
"052","Siena",26,1173,134,13,0,1320,997,314,2,0,1313
"052","Siena",27,1204,183,15,0,1402,979,404,4,0,1387
"052","Siena",28,1179,206,13,0,1398,1003,407,3,15,1428
"052","Siena",29,1153,288,11,0,1452,921,600,17,2,1540
"052","Siena",30,1088,351,10,0,1449,899,601,5,17,1522
"052","Siena",31,1039,472,15,1,1527,781,693,24,2,1500
"052","Siena",32,1025,531,14,0,1570,837,797,14,1,1649
"052","Siena",33,1107,627,13,0,1747,861,908,31,0,1800
"052","Siena",34,1013,787,13,1,1814,767,1018,38,5,1828
"052","Siena",35,952,838,10,1,1801,718,1113,47,5,1883
"052","Siena",36,988,893,23,7,1911,715,1195,57,18,1985
"052","Siena",37,933,1047,19,1,2000,681,1279,76,15,2051
"052","Siena",38,866,1100,12,12,1990,611,1317,59,14,2001
"052","Siena",39,855,1154,28,0,2037,624,1419,72,19,2134
"052","Siena",40,750,1249,45,4,2048,553,1349,73,18,1993
"052","Siena",41,711,1243,40,1,1995,509,1430,89,17,2045
"052","Siena",42,677,1344,56,5,2082,483,1558,102,24,2167
"052","Siena",43,606,1447,58,5,2116,477,1493,105,25,2100
"052","Siena",44,573,1491,72,9,2145,475,1555,132,35,2197
"052","Siena",45,535,1601,85,5,2226,422,1636,128,36,2222
"052","Siena",46,497,1497,84,5,2083,379,1582,94,31,2086
"052","Siena",47,435,1580,78,12,2105,349,1660,146,54,2209
"052","Siena",48,409,1502,97,12,2020,316,1507,124,47,1994
"052","Siena",49,349,1447,80,12,1888,332,1499,129,60,2020
"052","Siena",50,314,1471,84,11,1880,276,1555,112,67,2010
"052","Siena",51,318,1406,78,10,1812,221,1452,126,69,1868
"052","Siena",52,276,1506,77,17,1876,243,1480,106,90,1919
"052","Siena",53,250,1343,62,20,1675,212,1541,115,85,1953
"052","Siena",54,204,1352,79,16,1651,198,1405,106,74,1783
"052","Siena",55,205,1384,71,24,1684,213,1351,107,89,1760
"052","Siena",56,196,1294,91,17,1598,186,1394,92,124,1796
"052","Siena",57,170,1358,59,24,1611,163,1399,103,125,1790
"052","Siena",58,148,1327,63,27,1565,148,1342,113,143,1746
"052","Siena",59,147,1274,54,35,1510,125,1335,88,139,1687
"052","Siena",60,180,1314,40,34,1568,116,1270,78,135,1599
"052","Siena",61,165,1342,62,43,1612,113,1317,77,143,1650
"052","Siena",62,169,1381,57,33,1640,124,1436,61,181,1802
"052","Siena",63,137,1515,60,60,1772,131,1515,71,244,1961
"052","Siena",64,158,1518,58,50,1784,120,1510,58,251,1939
"052","Siena",65,137,1403,61,57,1658,101,1383,58,270,1812
"052","Siena",66,103,1077,24,57,1261,78,1137,42,252,1509
"052","Siena",67,115,1125,45,47,1332,64,1048,42,249,1403
"052","Siena",68,108,1161,29,61,1359,70,1080,44,302,1496
"052","Siena",69,111,1051,26,91,1279,76,940,33,315,1364
"052","Siena",70,118,1069,24,59,1270,77,1056,41,389,1563
"052","Siena",71,133,1300,24,97,1554,83,1208,37,476,1804
"052","Siena",72,138,1181,21,94,1434,66,1084,24,526,1700
"052","Siena",73,117,1181,17,110,1425,74,1055,27,569,1725
"052","Siena",74,113,1076,17,97,1303,69,910,30,588,1597
"052","Siena",75,108,1004,9,120,1241,67,744,22,587,1420
"052","Siena",76,105,992,14,102,1213,72,848,20,670,1610
"052","Siena",77,121,1005,10,121,1257,62,722,17,689,1490
"052","Siena",78,93,914,9,122,1138,68,665,15,741,1489
"052","Siena",79,81,783,11,130,1005,68,567,12,726,1373
"052","Siena",80,95,903,5,135,1138,72,553,9,844,1478
"052","Siena",81,101,784,6,146,1037,72,504,13,891,1480
"052","Siena",82,86,659,7,142,894,65,352,9,867,1293
"052","Siena",83,63,591,3,128,785,74,288,7,874,1243
"052","Siena",84,50,524,3,155,732,70,312,6,917,1305
"052","Siena",85,58,472,3,138,671,51,251,3,870,1175
"052","Siena",86,29,361,0,159,549,62,220,4,839,1125
"052","Siena",87,39,322,1,167,529,73,153,12,801,1039
"052","Siena",88,24,305,2,131,462,66,112,7,745,930
"052","Siena",89,25,235,1,128,389,54,76,2,701,833
"052","Siena",90,21,191,0,119,331,49,54,5,612,720
"052","Siena",91,14,143,0,98,255,37,53,3,519,612
"052","Siena",92,6,64,0,61,131,18,9,0,301,328
"052","Siena",93,7,25,1,40,73,21,3,0,162,186
"052","Siena",94,1,24,0,24,49,6,2,0,129,137
"052","Siena",95,1,25,0,22,48,15,1,0,135,151
"052","Siena",96,2,22,0,36,60,9,2,0,157,168
"052","Siena",97,1,14,0,25,40,6,4,0,120,130
"052","Siena",98,0,3,0,22,25,7,0,0,76,83
"052","Siena",99,0,2,0,8,10,6,0,0,68,74
"052","Siena",100,1,3,0,11,15,8,3,0,68,79
"053","Grosseto",0,888,0,0,0,888,806,0,0,0,806
"053","Grosseto",1,819,0,0,0,819,838,0,0,0,838
"053","Grosseto",2,902,0,0,0,902,820,0,0,0,820
"053","Grosseto",3,936,0,0,0,936,871,0,0,0,871
"053","Grosseto",4,932,0,0,0,932,863,0,0,0,863
"053","Grosseto",5,956,0,0,0,956,831,0,0,0,831
"053","Grosseto",6,898,0,0,0,898,860,0,0,0,860
"053","Grosseto",7,898,0,0,0,898,831,0,0,0,831
"053","Grosseto",8,891,0,0,0,891,851,0,0,0,851
"053","Grosseto",9,889,0,0,0,889,836,0,0,0,836
"053","Grosseto",10,854,0,0,0,854,851,0,0,0,851
"053","Grosseto",11,875,0,0,0,875,810,0,0,0,810
"053","Grosseto",12,859,0,0,0,859,862,0,0,0,862
"053","Grosseto",13,895,0,0,0,895,848,0,0,0,848
"053","Grosseto",14,832,0,0,0,832,826,0,0,0,826
"053","Grosseto",15,901,0,0,0,901,813,0,0,0,813
"053","Grosseto",16,827,0,0,0,827,717,0,0,0,717
"053","Grosseto",17,933,0,0,0,933,853,0,0,0,853
"053","Grosseto",18,879,0,0,0,879,839,2,0,0,841
"053","Grosseto",19,919,0,0,0,919,848,16,0,0,864
"053","Grosseto",20,983,2,0,0,985,894,29,0,0,923
"053","Grosseto",21,935,5,0,0,940,885,49,0,1,935
"053","Grosseto",22,985,14,0,0,999,874,71,0,0,945
"053","Grosseto",23,1001,23,0,1,1025,888,111,0,0,999
"053","Grosseto",24,926,35,0,0,961,757,131,3,1,892
"053","Grosseto",25,900,52,0,0,952,808,164,3,0,975
"053","Grosseto",26,968,84,0,0,1052,724,190,1,1,916
"053","Grosseto",27,921,110,1,0,1032,744,243,4,1,992
"053","Grosseto",28,992,146,0,0,1138,730,326,2,1,1059
"053","Grosseto",29,905,205,1,1,1112,761,395,6,1,1163
"053","Grosseto",30,929,250,3,0,1182,669,434,10,3,1116
"053","Grosseto",31,915,298,1,1,1215,597,488,9,0,1094
"053","Grosseto",32,858,397,6,0,1261,640,588,17,7,1252
"053","Grosseto",33,841,494,6,0,1341,665,614,25,3,1307
"053","Grosseto",34,863,527,11,0,1401,661,746,16,3,1426
"053","Grosseto",35,855,599,8,1,1463,677,821,34,6,1538
"053","Grosseto",36,878,714,21,1,1614,600,907,49,6,1562
"053","Grosseto",37,801,763,20,1,1585,624,966,67,7,1664
"053","Grosseto",38,744,842,33,2,1621,580,1014,66,9,1669
"053","Grosseto",39,744,851,44,5,1644,580,1123,71,9,1783
"053","Grosseto",40,629,984,30,1,1644,483,1122,90,23,1718
"053","Grosseto",41,624,972,56,7,1659,462,1127,94,18,1701
"053","Grosseto",42,588,1075,55,2,1720,454,1202,110,22,1788
"053","Grosseto",43,559,1092,65,3,1719,438,1183,108,27,1756
"053","Grosseto",44,489,1102,83,6,1680,404,1195,115,17,1731
"053","Grosseto",45,471,1169,94,9,1743,354,1284,113,46,1797
"053","Grosseto",46,426,1226,108,5,1765,365,1283,128,31,1807
"053","Grosseto",47,406,1254,95,10,1765,327,1355,135,42,1859
"053","Grosseto",48,387,1202,99,8,1696,291,1307,161,40,1799
"053","Grosseto",49,297,1162,86,10,1555,235,1228,132,46,1641
"053","Grosseto",50,302,1126,115,12,1555,271,1232,140,41,1684
"053","Grosseto",51,253,1211,98,13,1575,238,1212,132,60,1642
"053","Grosseto",52,256,1114,91,16,1477,246,1129,125,70,1570
"053","Grosseto",53,242,1082,99,14,1437,240,1190,134,76,1640
"053","Grosseto",54,223,1138,96,15,1472,229,1221,118,81,1649
"053","Grosseto",55,192,1198,102,22,1514,221,1220,108,89,1638
"053","Grosseto",56,198,1137,102,19,1456,197,1230,123,93,1643
"053","Grosseto",57,182,1182,84,24,1472,184,1159,118,118,1579
"053","Grosseto",58,178,1162,71,27,1438,151,1158,92,105,1506
"053","Grosseto",59,121,1171,99,30,1421,145,1070,75,135,1425
"053","Grosseto",60,158,1107,68,27,1360,141,1071,99,131,1442
"053","Grosseto",61,149,1237,72,36,1494,162,1165,79,133,1539
"053","Grosseto",62,139,1287,68,44,1538,136,1239,74,204,1653
"053","Grosseto",63,122,1350,73,47,1592,125,1305,78,220,1728
"053","Grosseto",64,112,1344,64,51,1571,117,1287,72,232,1708
"053","Grosseto",65,119,1332,54,75,1580,102,1258,50,284,1694
"053","Grosseto",66,81,1074,38,64,1257,74,1018,42,262,1396
"053","Grosseto",67,92,1008,50,57,1207,65,945,43,258,1311
"053","Grosseto",68,92,1019,37,45,1193,77,952,39,270,1338
"053","Grosseto",69,99,958,29,48,1134,73,932,38,307,1350
"053","Grosseto",70,78,1014,35,76,1203,69,924,34,339,1366
"053","Grosseto",71,100,1078,44,76,1298,76,1025,40,457,1598
"053","Grosseto",72,103,1046,26,102,1277,74,899,31,533,1537
"053","Grosseto",73,111,1058,32,91,1292,96,872,37,503,1508
"053","Grosseto",74,86,942,18,90,1136,84,780,28,543,1435
"053","Grosseto",75,76,808,20,98,1002,66,701,19,496,1282
"053","Grosseto",76,77,853,12,92,1034,72,635,25,565,1297
"053","Grosseto",77,64,827,10,106,1007,50,551,18,619,1238
"053","Grosseto",78,72,730,8,112,922,61,508,18,644,1231
"053","Grosseto",79,50,713,12,103,878,56,412,22,662,1152
"053","Grosseto",80,52,658,6,128,844,52,444,14,706,1216
"053","Grosseto",81,53,571,9,135,768,49,362,15,760,1186
"053","Grosseto",82,50,488,4,117,659,54,276,6,697,1033
"053","Grosseto",83,45,475,8,134,662,66,271,13,766,1116
"053","Grosseto",84,50,472,5,134,661,39,217,8,766,1030
"053","Grosseto",85,40,331,5,116,492,55,175,8,757,995
"053","Grosseto",86,39,314,3,127,483,37,144,5,655,841
"053","Grosseto",87,25,228,2,120,375,47,130,9,634,820
"053","Grosseto",88,23,200,2,119,344,40,85,2,576,703
"053","Grosseto",89,8,143,2,85,238,35,67,3,500,605
"053","Grosseto",90,14,153,1,92,260,33,42,4,448,527
"053","Grosseto",91,2,107,0,93,202,13,24,1,384,422
"053","Grosseto",92,8,59,0,44,111,8,9,0,235,252
"053","Grosseto",93,2,26,0,33,61,12,5,1,123,141
"053","Grosseto",94,3,22,1,26,52,5,1,0,99,105
"053","Grosseto",95,3,14,0,21,38,3,1,1,109,114
"053","Grosseto",96,1,6,0,18,25,7,3,0,103,113
"053","Grosseto",97,0,10,0,23,33,7,2,0,86,95
"053","Grosseto",98,0,5,0,7,12,5,1,0,56,62
"053","Grosseto",99,0,2,0,6,8,5,1,0,33,39
"053","Grosseto",100,1,1,0,8,10,1,0,1,47,49
"054","Perugia",0,2918,0,0,0,2918,2832,0,0,0,2832
"054","Perugia",1,3045,0,0,0,3045,2865,0,0,0,2865
"054","Perugia",2,3143,0,0,0,3143,2885,0,0,0,2885
"054","Perugia",3,3119,0,0,0,3119,3123,0,0,0,3123
"054","Perugia",4,3110,0,0,0,3110,2954,0,0,0,2954
"054","Perugia",5,3144,0,0,0,3144,2904,0,0,0,2904
"054","Perugia",6,3139,0,0,0,3139,2955,0,0,0,2955
"054","Perugia",7,2977,0,0,0,2977,2815,0,0,0,2815
"054","Perugia",8,3006,0,0,0,3006,2740,0,0,0,2740
"054","Perugia",9,2887,0,0,0,2887,2790,0,0,0,2790
"054","Perugia",10,2870,0,0,0,2870,2762,0,0,0,2762
"054","Perugia",11,2879,0,0,0,2879,2831,0,0,0,2831
"054","Perugia",12,2974,0,0,0,2974,2595,0,0,0,2595
"054","Perugia",13,2884,0,0,0,2884,2660,0,0,0,2660
"054","Perugia",14,2817,0,0,0,2817,2691,0,0,0,2691
"054","Perugia",15,2859,0,0,0,2859,2692,0,0,0,2692
"054","Perugia",16,2852,0,0,0,2852,2746,0,0,0,2746
"054","Perugia",17,2818,0,0,0,2818,2679,1,0,0,2680
"054","Perugia",18,2999,0,0,0,2999,2794,14,0,0,2808
"054","Perugia",19,3175,5,0,0,3180,2909,61,0,0,2970
"054","Perugia",20,3106,6,0,0,3112,2805,100,0,0,2905
"054","Perugia",21,3153,19,0,0,3172,2859,188,2,0,3049
"054","Perugia",22,3302,45,1,0,3348,2875,268,0,0,3143
"054","Perugia",23,3284,98,1,0,3383,3003,389,2,1,3395
"054","Perugia",24,3102,148,3,0,3253,2796,547,1,2,3346
"054","Perugia",25,3117,227,1,0,3345,2678,676,7,1,3362
"054","Perugia",26,3173,293,1,1,3468,2767,817,8,2,3594
"054","Perugia",27,3063,438,5,0,3506,2529,1115,10,1,3655
"054","Perugia",28,3295,628,5,1,3929,2458,1339,17,3,3817
"054","Perugia",29,2994,802,2,0,3798,2263,1448,24,6,3741
"054","Perugia",30,2834,1086,4,0,3924,2124,1832,21,4,3981
"054","Perugia",31,2710,1316,9,2,4037,1972,2044,34,2,4052
"054","Perugia",32,2583,1579,17,0,4179,1779,2341,50,11,4181
"054","Perugia",33,2465,1827,19,0,4311,1809,2547,54,10,4420
"054","Perugia",34,2351,2139,19,1,4510,1641,2746,78,14,4479
"054","Perugia",35,2316,2244,40,2,4602,1577,3057,87,16,4737
"054","Perugia",36,2164,2572,39,2,4777,1569,3275,122,20,4986
"054","Perugia",37,2050,2953,60,5,5068,1471,3466,129,30,5096
"054","Perugia",38,1947,2975,61,5,4988,1328,3505,160,35,5028
"054","Perugia",39,1745,3095,83,4,4927,1267,3575,161,28,5031
"054","Perugia",40,1591,3233,110,9,4943,1137,3702,181,34,5054
"054","Perugia",41,1508,3304,114,5,4931,1052,3647,172,38,4909
"054","Perugia",42,1374,3476,111,10,4971,1014,3883,232,52,5181
"054","Perugia",43,1257,3519,113,7,4896,999,3914,239,82,5234
"054","Perugia",44,1177,3556,142,14,4889,967,3940,200,61,5168
"054","Perugia",45,1156,3663,157,15,4991,865,3907,230,77,5079
"054","Perugia",46,1069,3864,153,20,5106,838,4126,263,98,5325
"054","Perugia",47,992,4054,185,25,5256,751,4171,305,108,5335
"054","Perugia",48,862,3619,172,26,4679,708,4025,262,107,5102
"054","Perugia",49,824,3595,192,23,4634,599,3997,258,122,4976
"054","Perugia",50,765,3835,178,23,4801,599,3895,261,155,4910
"054","Perugia",51,675,3788,192,28,4683,577,3922,283,158,4940
"054","Perugia",52,629,3619,178,39,4465,551,3742,257,171,4721
"054","Perugia",53,586,3375,140,44,4145,521,3487,237,176,4421
"054","Perugia",54,556,3362,155,47,4120,456,3540,226,221,4443
"054","Perugia",55,503,3514,165,53,4235,451,3497,227,199,4374
"054","Perugia",56,496,3421,139,55,4111,417,3451,190,221,4279
"054","Perugia",57,447,3357,149,52,4005,374,3448,185,274,4281
"054","Perugia",58,415,3383,133,58,3989,354,3274,173,331,4132
"054","Perugia",59,368,3079,96,62,3605,337,3100,157,317,3911
"054","Perugia",60,367,3284,118,70,3839,298,3294,171,380,4143
"054","Perugia",61,352,3412,128,108,4000,307,3286,162,405,4160
"054","Perugia",62,320,3498,122,106,4046,294,3441,163,478,4376
"054","Perugia",63,353,3685,118,114,4270,302,3623,143,569,4637
"054","Perugia",64,347,3411,101,131,3990,263,3255,135,599,4252
"054","Perugia",65,319,3216,95,129,3759,240,3213,110,627,4190
"054","Perugia",66,258,2605,64,105,3032,196,2495,90,552,3333
"054","Perugia",67,284,2763,57,126,3230,205,2663,87,701,3656
"054","Perugia",68,283,2953,52,148,3436,217,2658,87,756,3718
"054","Perugia",69,268,2626,59,162,3115,199,2361,69,790,3419
"054","Perugia",70,262,2662,55,171,3150,192,2392,77,861,3522
"054","Perugia",71,283,2947,50,196,3476,230,2607,79,1072,3988
"054","Perugia",72,255,2830,53,233,3371,224,2534,72,1146,3976
"054","Perugia",73,300,2944,55,243,3542,181,2490,55,1312,4038
"054","Perugia",74,206,2503,38,228,2975,163,2100,64,1379,3706
"054","Perugia",75,203,2267,25,239,2734,183,1892,37,1413,3525
"054","Perugia",76,219,2298,35,259,2811,182,1840,40,1465,3527
"054","Perugia",77,205,2233,31,304,2773,202,1697,27,1602,3528
"054","Perugia",78,191,2059,28,291,2569,181,1481,34,1634,3330
"054","Perugia",79,170,1909,21,254,2354,187,1290,26,1644,3147
"054","Perugia",80,164,1874,17,347,2402,185,1222,32,1951,3390
"054","Perugia",81,159,1797,15,328,2299,174,1104,18,2031,3327
"054","Perugia",82,106,1430,8,322,1866,163,854,26,1888,2931
"054","Perugia",83,108,1328,10,296,1742,159,756,17,1855,2787
"054","Perugia",84,102,1205,3,341,1651,168,683,18,1912,2781
"054","Perugia",85,91,1061,7,350,1509,172,583,27,1869,2651
"054","Perugia",86,67,863,8,328,1266,147,499,16,1828,2490
"054","Perugia",87,57,726,1,341,1125,149,390,16,1633,2188
"054","Perugia",88,48,570,0,305,923,146,315,12,1525,1998
"054","Perugia",89,34,446,2,269,751,113,245,7,1364,1729
"054","Perugia",90,32,391,3,260,686,99,206,8,1238,1551
"054","Perugia",91,23,260,3,199,485,67,121,5,1068,1261
"054","Perugia",92,11,171,2,114,298,56,91,3,592,742
"054","Perugia",93,6,76,1,73,156,32,49,2,318,401
"054","Perugia",94,11,48,1,58,118,26,45,0,293,364
"054","Perugia",95,9,55,0,47,111,32,36,0,257,325
"054","Perugia",96,4,37,0,58,99,33,32,0,269,334
"054","Perugia",97,3,21,0,34,58,11,31,1,206,249
"054","Perugia",98,2,8,1,30,41,6,26,1,120,153
"054","Perugia",99,1,6,0,23,30,8,5,0,105,118
"054","Perugia",100,1,2,0,23,26,11,17,0,140,168
"055","Terni",0,889,0,0,0,889,845,0,0,0,845
"055","Terni",1,949,0,0,0,949,944,0,0,0,944
"055","Terni",2,900,0,0,0,900,848,0,0,0,848
"055","Terni",3,1011,0,0,0,1011,908,0,0,0,908
"055","Terni",4,1029,0,0,0,1029,967,0,0,0,967
"055","Terni",5,970,0,0,0,970,940,0,0,0,940
"055","Terni",6,994,0,0,0,994,879,0,0,0,879
"055","Terni",7,949,0,0,0,949,931,0,0,0,931
"055","Terni",8,934,0,0,0,934,870,0,0,0,870
"055","Terni",9,954,0,0,0,954,934,0,0,0,934
"055","Terni",10,921,0,0,0,921,873,0,0,0,873
"055","Terni",11,964,0,0,0,964,920,0,0,0,920
"055","Terni",12,991,0,0,0,991,932,0,0,0,932
"055","Terni",13,983,0,0,0,983,890,0,0,0,890
"055","Terni",14,931,0,0,0,931,875,0,0,0,875
"055","Terni",15,939,0,0,0,939,884,0,0,0,884
"055","Terni",16,950,0,0,0,950,863,0,0,0,863
"055","Terni",17,954,0,0,0,954,919,0,0,0,919
"055","Terni",18,880,0,0,0,880,908,5,0,0,913
"055","Terni",19,976,0,0,0,976,913,16,0,0,929
"055","Terni",20,991,2,0,0,993,908,28,1,0,937
"055","Terni",21,996,9,0,0,1005,984,51,0,0,1035
"055","Terni",22,1012,12,0,0,1024,930,56,0,0,986
"055","Terni",23,1096,27,0,0,1123,917,96,2,0,1015
"055","Terni",24,1050,51,0,0,1101,859,133,1,1,994
"055","Terni",25,1070,50,0,0,1120,930,187,2,0,1119
"055","Terni",26,1028,83,0,0,1111,891,238,0,0,1129
"055","Terni",27,1008,118,0,0,1126,783,270,4,0,1057
"055","Terni",28,1005,168,1,0,1174,843,360,1,1,1205
"055","Terni",29,1010,242,1,0,1253,810,442,1,0,1253
"055","Terni",30,944,308,4,0,1256,752,493,5,1,1251
"055","Terni",31,916,350,3,0,1269,638,560,12,3,1213
"055","Terni",32,868,457,4,0,1329,657,674,14,3,1348
"055","Terni",33,849,524,7,0,1380,678,791,28,3,1500
"055","Terni",34,860,645,7,1,1513,568,893,16,4,1481
"055","Terni",35,858,734,13,1,1606,561,870,34,4,1469
"055","Terni",36,734,811,13,0,1558,540,1046,46,7,1639
"055","Terni",37,679,904,13,1,1597,523,1187,54,12,1776
"055","Terni",38,697,950,24,1,1672,506,1196,62,4,1768
"055","Terni",39,622,990,36,2,1650,491,1195,73,7,1766
"055","Terni",40,595,1062,29,5,1691,459,1314,66,9,1848
"055","Terni",41,534,1100,49,4,1687,424,1210,75,14,1723
"055","Terni",42,480,1247,51,1,1779,397,1327,85,16,1825
"055","Terni",43,471,1274,48,4,1797,380,1344,93,23,1840
"055","Terni",44,427,1242,55,5,1729,372,1295,87,20,1774
"055","Terni",45,424,1220,64,11,1719,320,1392,99,33,1844
"055","Terni",46,374,1335,71,7,1787,337,1382,112,33,1864
"055","Terni",47,339,1337,88,5,1769,311,1419,101,47,1878
"055","Terni",48,292,1332,75,10,1709,292,1377,98,40,1807
"055","Terni",49,293,1245,85,13,1636,261,1314,103,40,1718
"055","Terni",50,272,1235,82,10,1599,247,1297,97,50,1691
"055","Terni",51,215,1243,65,8,1531,245,1286,102,61,1694
"055","Terni",52,200,1159,70,16,1445,219,1264,91,67,1641
"055","Terni",53,245,1174,67,10,1496,197,1163,102,80,1542
"055","Terni",54,190,1128,69,20,1407,212,1117,91,70,1490
"055","Terni",55,172,1199,56,14,1441,205,1222,97,98,1622
"055","Terni",56,172,1183,58,23,1436,181,1228,101,97,1607
"055","Terni",57,160,1130,61,23,1374,171,1241,87,85,1584
"055","Terni",58,140,1121,63,26,1350,158,1143,89,112,1502
"055","Terni",59,124,1100,73,28,1325,141,1180,62,114,1497
"055","Terni",60,138,1185,55,28,1406,131,1151,75,133,1490
"055","Terni",61,125,1121,67,35,1348,128,1212,69,175,1584
"055","Terni",62,130,1259,74,42,1505,137,1248,75,165,1625
"055","Terni",63,131,1433,59,49,1672,125,1315,59,201,1700
"055","Terni",64,129,1313,53,54,1549,98,1287,47,214,1646
"055","Terni",65,103,1295,42,53,1493,102,1279,51,242,1674
"055","Terni",66,101,1019,32,53,1205,78,1003,59,218,1358
"055","Terni",67,92,1010,24,51,1177,103,1018,40,245,1406
"055","Terni",68,97,1115,29,54,1295,81,1076,40,314,1511
"055","Terni",69,84,1097,34,53,1268,73,996,57,301,1427
"055","Terni",70,90,1121,26,54,1291,71,980,33,322,1406
"055","Terni",71,103,1222,25,89,1439,72,998,30,410,1510
"055","Terni",72,99,1114,20,83,1316,80,905,32,469,1486
"055","Terni",73,92,1103,12,109,1316,76,878,33,544,1531
"055","Terni",74,74,972,16,97,1159,73,823,24,544,1464
"055","Terni",75,75,852,14,99,1040,44,678,19,514,1255
"055","Terni",76,68,891,15,106,1080,90,643,16,598,1347
"055","Terni",77,81,784,12,98,975,73,596,20,637,1326
"055","Terni",78,68,822,13,116,1019,70,543,11,713,1337
"055","Terni",79,59,718,9,125,911,65,482,16,628,1191
"055","Terni",80,52,664,8,126,850,58,418,12,760,1248
"055","Terni",81,52,651,11,145,859,68,432,15,826,1341
"055","Terni",82,45,535,2,135,717,59,347,16,770,1192
"055","Terni",83,35,484,3,149,671,51,277,9,776,1113
"055","Terni",84,28,435,7,131,601,63,251,7,767,1088
"055","Terni",85,19,416,3,126,564,54,199,5,701,959
"055","Terni",86,27,322,1,132,482,47,158,8,667,880
"055","Terni",87,22,275,3,144,444,48,131,9,639,827
"055","Terni",88,12,214,1,130,357,40,89,5,650,784
"055","Terni",89,7,165,1,120,293,38,65,5,559,667
"055","Terni",90,6,142,0,92,240,30,42,8,489,569
"055","Terni",91,4,106,0,89,199,28,34,0,413,475
"055","Terni",92,3,46,0,41,90,10,11,2,236,259
"055","Terni",93,1,32,0,31,64,10,13,1,149,173
"055","Terni",94,1,24,0,26,51,13,4,3,123,143
"055","Terni",95,1,23,0,31,55,12,5,0,117,134
"055","Terni",96,2,6,0,25,33,6,3,1,102,112
"055","Terni",97,1,9,0,20,30,5,2,0,65,72
"055","Terni",98,0,2,0,9,11,8,0,1,57,66
"055","Terni",99,0,4,0,6,10,3,2,0,39,44
"055","Terni",100,0,5,0,8,13,2,1,0,57,60
"056","Viterbo",0,1322,0,0,0,1322,1226,0,0,0,1226
"056","Viterbo",1,1308,0,0,0,1308,1278,0,0,0,1278
"056","Viterbo",2,1370,0,0,0,1370,1319,0,0,0,1319
"056","Viterbo",3,1411,0,0,0,1411,1347,0,0,0,1347
"056","Viterbo",4,1352,0,0,0,1352,1252,0,0,0,1252
"056","Viterbo",5,1370,0,0,0,1370,1385,0,0,0,1385
"056","Viterbo",6,1321,0,0,0,1321,1284,0,0,0,1284
"056","Viterbo",7,1345,0,0,0,1345,1235,0,0,0,1235
"056","Viterbo",8,1338,0,0,0,1338,1227,0,0,0,1227
"056","Viterbo",9,1334,0,0,0,1334,1284,0,0,0,1284
"056","Viterbo",10,1359,0,0,0,1359,1305,0,0,0,1305
"056","Viterbo",11,1369,0,0,0,1369,1300,0,0,0,1300
"056","Viterbo",12,1284,0,0,0,1284,1266,0,0,0,1266
"056","Viterbo",13,1376,0,0,0,1376,1268,0,0,0,1268
"056","Viterbo",14,1305,0,0,0,1305,1324,0,0,0,1324
"056","Viterbo",15,1332,0,0,0,1332,1261,0,0,0,1261
"056","Viterbo",16,1412,0,0,0,1412,1352,0,0,0,1352
"056","Viterbo",17,1364,0,0,0,1364,1358,0,0,0,1358
"056","Viterbo",18,1480,0,0,0,1480,1308,3,0,0,1311
"056","Viterbo",19,1547,2,0,0,1549,1399,18,0,0,1417
"056","Viterbo",20,1517,5,0,0,1522,1346,24,0,0,1370
"056","Viterbo",21,1572,9,2,0,1583,1476,47,0,0,1523
"056","Viterbo",22,1575,18,1,0,1594,1420,105,2,0,1527
"056","Viterbo",23,1654,34,0,0,1688,1504,132,1,1,1638
"056","Viterbo",24,1667,56,0,0,1723,1453,189,2,0,1644
"056","Viterbo",25,1603,73,1,0,1677,1330,274,4,2,1610
"056","Viterbo",26,1614,115,2,0,1731,1362,340,5,0,1707
"056","Viterbo",27,1585,181,1,0,1767,1329,391,4,0,1724
"056","Viterbo",28,1509,225,2,0,1736,1286,574,3,1,1864
"056","Viterbo",29,1532,322,0,0,1854,1242,668,18,3,1931
"056","Viterbo",30,1508,470,2,0,1980,1194,828,9,4,2035
"056","Viterbo",31,1368,566,6,0,1940,988,925,22,2,1937
"056","Viterbo",32,1347,712,8,0,2067,952,1026,23,4,2005
"056","Viterbo",33,1326,852,15,1,2194,873,1229,31,9,2142
"056","Viterbo",34,1197,1013,11,0,2221,813,1313,28,5,2159
"056","Viterbo",35,1155,1078,18,1,2252,750,1429,62,8,2249
"056","Viterbo",36,1157,1251,25,1,2434,730,1588,71,15,2404
"056","Viterbo",37,1085,1330,28,2,2445,686,1647,75,7,2415
"056","Viterbo",38,937,1365,46,4,2352,626,1693,87,12,2418
"056","Viterbo",39,837,1505,44,1,2387,593,1758,102,16,2469
"056","Viterbo",40,788,1513,58,1,2360,518,1818,88,27,2451
"056","Viterbo",41,732,1608,55,3,2398,483,1769,97,24,2373
"056","Viterbo",42,656,1623,75,2,2356,493,1861,113,38,2505
"056","Viterbo",43,614,1705,68,9,2396,435,1880,110,37,2462
"056","Viterbo",44,572,1795,83,3,2453,440,1964,105,41,2550
"056","Viterbo",45,551,1900,100,6,2557,405,1925,124,45,2499
"056","Viterbo",46,544,1938,93,7,2582,401,1978,122,53,2554
"056","Viterbo",47,514,1948,101,11,2574,352,1993,160,64,2569
"056","Viterbo",48,408,1862,96,12,2378,300,1930,134,75,2439
"056","Viterbo",49,413,1800,108,20,2341,282,1871,127,87,2367
"056","Viterbo",50,352,1816,95,16,2279,273,1893,133,77,2376
"056","Viterbo",51,298,1773,94,22,2187,238,1845,124,95,2302
"056","Viterbo",52,299,1800,89,22,2210,247,1771,129,105,2252
"056","Viterbo",53,267,1728,95,28,2118,230,1737,120,121,2208
"056","Viterbo",54,256,1731,99,23,2109,220,1798,113,128,2259
"056","Viterbo",55,257,1706,85,27,2075,189,1740,111,149,2189
"056","Viterbo",56,259,1738,77,32,2106,200,1752,99,148,2199
"056","Viterbo",57,216,1762,78,37,2093,155,1749,106,162,2172
"056","Viterbo",58,199,1710,76,38,2023,169,1639,83,165,2056
"056","Viterbo",59,172,1651,62,44,1929,175,1579,88,176,2018
"056","Viterbo",60,193,1583,88,40,1904,123,1565,83,203,1974
"056","Viterbo",61,164,1743,80,49,2036,118,1547,65,221,1951
"056","Viterbo",62,199,1665,74,51,1989,140,1596,83,290,2109
"056","Viterbo",63,176,1819,54,76,2125,117,1624,61,330,2132
"056","Viterbo",64,187,1807,62,61,2117,116,1660,68,331,2175
"056","Viterbo",65,174,1674,48,82,1978,120,1566,61,386,2133
"056","Viterbo",66,119,1387,44,76,1626,114,1277,49,340,1780
"056","Viterbo",67,133,1392,40,79,1644,97,1231,50,385,1763
"056","Viterbo",68,112,1391,41,78,1622,104,1193,52,384,1733
"056","Viterbo",69,100,1248,39,74,1461,80,1121,36,397,1634
"056","Viterbo",70,122,1301,40,92,1555,94,1055,34,455,1638
"056","Viterbo",71,128,1332,34,123,1617,98,1108,45,582,1833
"056","Viterbo",72,117,1383,32,128,1660,90,1060,39,644,1833
"056","Viterbo",73,90,1310,27,127,1554,99,1037,24,648,1808
"056","Viterbo",74,101,1175,24,122,1422,95,922,24,682,1723
"056","Viterbo",75,100,1090,16,138,1344,97,836,21,711,1665
"056","Viterbo",76,95,1026,17,149,1287,80,732,20,750,1582
"056","Viterbo",77,86,1019,11,131,1247,70,682,16,781,1549
"056","Viterbo",78,74,930,15,145,1164,77,637,17,822,1553
"056","Viterbo",79,74,851,11,154,1090,79,505,16,832,1432
"056","Viterbo",80,64,748,11,163,986,86,462,18,844,1410
"056","Viterbo",81,70,709,15,149,943,68,457,15,953,1493
"056","Viterbo",82,63,648,4,148,863,73,337,11,872,1293
"056","Viterbo",83,42,538,3,160,743,80,282,10,894,1266
"056","Viterbo",84,48,507,6,158,719,66,260,6,936,1268
"056","Viterbo",85,33,393,5,157,588,64,205,6,838,1113
"056","Viterbo",86,19,372,2,154,547,63,174,9,730,976
"056","Viterbo",87,28,305,3,152,488,63,114,8,684,869
"056","Viterbo",88,33,214,2,135,384,64,87,5,671,827
"056","Viterbo",89,18,172,1,136,327,63,57,3,595,718
"056","Viterbo",90,6,125,1,99,231,47,39,7,525,618
"056","Viterbo",91,6,94,0,106,206,36,22,3,455,516
"056","Viterbo",92,9,47,1,65,122,21,11,6,218,256
"056","Viterbo",93,1,18,0,26,45,8,5,2,117,132
"056","Viterbo",94,2,12,0,20,34,10,6,1,112,129
"056","Viterbo",95,2,14,0,23,39,10,5,0,109,124
"056","Viterbo",96,1,10,0,18,29,4,2,1,101,108
"056","Viterbo",97,2,8,0,14,24,3,1,1,72,77
"056","Viterbo",98,0,5,0,14,19,5,6,0,49,60
"056","Viterbo",99,1,4,0,6,11,5,0,0,36,41
"056","Viterbo",100,0,2,0,6,8,3,0,0,37,40
"057","Rieti",0,599,0,0,0,599,617,0,0,0,617
"057","Rieti",1,580,0,0,0,580,585,0,0,0,585
"057","Rieti",2,666,0,0,0,666,591,0,0,0,591
"057","Rieti",3,646,0,0,0,646,615,0,0,0,615
"057","Rieti",4,645,0,0,0,645,594,0,0,0,594
"057","Rieti",5,694,0,0,0,694,597,0,0,0,597
"057","Rieti",6,633,0,0,0,633,587,0,0,0,587
"057","Rieti",7,652,0,0,0,652,584,0,0,0,584
"057","Rieti",8,668,0,0,0,668,579,0,0,0,579
"057","Rieti",9,634,0,0,0,634,618,0,0,0,618
"057","Rieti",10,611,0,0,0,611,607,0,0,0,607
"057","Rieti",11,648,0,0,0,648,659,0,0,0,659
"057","Rieti",12,646,0,0,0,646,678,0,0,0,678
"057","Rieti",13,655,0,0,0,655,629,0,0,0,629
"057","Rieti",14,688,0,0,0,688,625,0,0,0,625
"057","Rieti",15,708,0,0,0,708,653,0,0,0,653
"057","Rieti",16,756,0,0,0,756,671,1,0,0,672
"057","Rieti",17,765,0,0,0,765,707,0,0,0,707
"057","Rieti",18,742,0,0,0,742,698,2,0,0,700
"057","Rieti",19,790,1,0,0,791,732,5,0,0,737
"057","Rieti",20,818,0,0,1,819,746,14,0,0,760
"057","Rieti",21,773,6,0,0,779,712,23,0,0,735
"057","Rieti",22,790,8,0,0,798,748,41,0,0,789
"057","Rieti",23,778,21,0,0,799,742,54,0,0,796
"057","Rieti",24,812,25,0,0,837,731,93,0,0,824
"057","Rieti",25,739,32,0,0,771,735,114,0,0,849
"057","Rieti",26,796,52,1,1,850,620,174,3,0,797
"057","Rieti",27,763,92,0,0,855,639,217,2,0,858
"057","Rieti",28,763,144,3,0,910,581,231,2,0,814
"057","Rieti",29,732,158,0,0,890,507,310,5,1,823
"057","Rieti",30,704,201,0,0,905,544,387,6,1,938
"057","Rieti",31,667,236,0,0,903,509,370,10,2,891
"057","Rieti",32,633,341,2,0,976,443,470,12,0,925
"057","Rieti",33,651,394,4,1,1050,433,547,12,4,996
"057","Rieti",34,593,464,3,0,1060,415,614,12,4,1045
"057","Rieti",35,506,509,4,0,1019,410,630,20,5,1065
"057","Rieti",36,546,569,7,0,1122,373,703,42,7,1125
"057","Rieti",37,521,618,9,0,1148,307,801,28,3,1139
"057","Rieti",38,475,646,13,1,1135,301,770,36,9,1116
"057","Rieti",39,413,721,20,2,1156,281,809,37,13,1140
"057","Rieti",40,356,665,18,3,1042,245,857,40,8,1150
"057","Rieti",41,341,735,19,1,1096,262,906,40,12,1220
"057","Rieti",42,377,814,33,0,1224,195,884,42,12,1133
"057","Rieti",43,308,790,24,1,1123,222,944,50,12,1228
"057","Rieti",44,318,847,31,1,1197,201,931,43,23,1198
"057","Rieti",45,298,879,32,4,1213,193,947,53,25,1218
"057","Rieti",46,263,955,43,8,1269,183,996,52,22,1253
"057","Rieti",47,253,966,35,10,1264,172,986,67,31,1256
"057","Rieti",48,233,938,47,12,1230,141,964,59,46,1210
"057","Rieti",49,189,915,58,7,1169,170,948,61,35,1214
"057","Rieti",50,184,931,43,12,1170,166,908,55,47,1176
"057","Rieti",51,174,936,40,8,1158,120,930,51,52,1153
"057","Rieti",52,151,877,30,5,1063,123,874,48,52,1097
"057","Rieti",53,147,849,35,8,1039,105,884,49,58,1096
"057","Rieti",54,119,816,37,15,987,85,839,43,77,1044
"057","Rieti",55,138,863,31,14,1046,92,834,46,75,1047
"057","Rieti",56,139,851,41,11,1042,88,810,36,70,1004
"057","Rieti",57,107,873,26,17,1023,69,840,33,89,1031
"057","Rieti",58,109,810,38,17,974,82,825,30,91,1028
"057","Rieti",59,103,822,41,27,993,76,782,26,79,963
"057","Rieti",60,86,852,36,11,985,63,810,36,108,1017
"057","Rieti",61,99,922,41,34,1096,70,801,35,127,1033
"057","Rieti",62,88,903,36,25,1052,78,801,28,103,1010
"057","Rieti",63,88,931,34,41,1094,74,880,21,151,1126
"057","Rieti",64,85,878,40,36,1039,61,757,19,163,1000
"057","Rieti",65,82,838,18,26,964,47,738,19,164,968
"057","Rieti",66,60,681,23,32,796,45,613,21,145,824
"057","Rieti",67,63,702,24,36,825,64,568,19,156,807
"057","Rieti",68,60,700,20,43,823,48,609,25,185,867
"057","Rieti",69,68,606,15,41,730,37,567,11,186,801
"057","Rieti",70,72,611,19,39,741,39,564,15,241,859
"057","Rieti",71,50,710,25,66,851,59,661,13,287,1020
"057","Rieti",72,78,652,13,58,801,47,548,12,305,912
"057","Rieti",73,57,710,19,63,849,48,555,13,312,928
"057","Rieti",74,45,631,15,76,767,43,478,13,359,893
"057","Rieti",75,51,599,9,52,711,39,412,6,297,754
"057","Rieti",76,61,596,8,81,746,44,476,5,359,884
"057","Rieti",77,52,526,5,72,655,36,398,7,359,800
"057","Rieti",78,40,519,9,74,642,47,350,3,401,801
"057","Rieti",79,45,439,3,67,554,41,288,4,354,687
"057","Rieti",80,39,437,2,90,568,42,310,3,453,808
"057","Rieti",81,36,454,0,99,589,52,285,6,428,771
"057","Rieti",82,21,359,1,106,487,42,221,0,421,684
"057","Rieti",83,29,303,1,97,430,47,192,1,414,654
"057","Rieti",84,21,276,1,94,392,36,190,5,466,697
"057","Rieti",85,20,265,1,91,377,39,119,4,457,619
"057","Rieti",86,21,207,0,79,307,33,122,5,440,600
"057","Rieti",87,15,176,1,86,278,35,90,2,393,520
"057","Rieti",88,9,145,1,70,225,30,69,1,347,447
"057","Rieti",89,13,123,0,74,210,27,58,0,309,394
"057","Rieti",90,6,81,0,60,147,26,39,1,281,347
"057","Rieti",91,8,64,0,47,119,17,22,1,223,263
"057","Rieti",92,1,36,0,34,71,11,15,0,138,164
"057","Rieti",93,3,22,0,21,46,5,3,1,88,97
"057","Rieti",94,1,14,0,18,33,5,4,1,79,89
"057","Rieti",95,1,16,0,14,31,5,0,0,77,82
"057","Rieti",96,2,9,0,15,26,6,3,0,67,76
"057","Rieti",97,2,8,0,16,26,2,4,0,46,52
"057","Rieti",98,0,9,0,15,24,8,0,0,37,45
"057","Rieti",99,0,2,0,6,8,6,1,0,23,30
"057","Rieti",100,1,5,0,5,11,7,1,0,36,44
"058","Roma",0,19597,0,0,0,19597,18445,0,0,0,18445
"058","Roma",1,19588,0,0,0,19588,18513,0,0,0,18513
"058","Roma",2,19911,0,0,0,19911,18633,0,0,0,18633
"058","Roma",3,19910,0,0,0,19910,19097,0,0,0,19097
"058","Roma",4,20264,0,0,0,20264,19101,0,0,0,19101
"058","Roma",5,20050,0,0,0,20050,18944,0,0,0,18944
"058","Roma",6,19516,0,0,0,19516,18245,0,0,0,18245
"058","Roma",7,19371,0,0,0,19371,18442,0,0,0,18442
"058","Roma",8,19045,0,0,0,19045,18268,0,0,0,18268
"058","Roma",9,18690,0,0,0,18690,17691,0,0,0,17691
"058","Roma",10,18655,0,0,0,18655,17832,0,0,0,17832
"058","Roma",11,18799,0,0,0,18799,17825,0,0,0,17825
"058","Roma",12,18252,0,0,0,18252,17235,0,0,0,17235
"058","Roma",13,18559,0,0,0,18559,17594,0,0,0,17594
"058","Roma",14,18120,0,0,0,18120,17325,0,0,0,17325
"058","Roma",15,18306,0,0,0,18306,17214,0,0,0,17214
"058","Roma",16,18299,1,0,0,18300,17167,2,0,0,17169
"058","Roma",17,18508,0,0,0,18508,17427,3,0,0,17430
"058","Roma",18,18935,3,0,0,18938,17847,19,0,0,17866
"058","Roma",19,19668,7,0,0,19675,18264,90,1,0,18355
"058","Roma",20,19363,26,0,0,19389,18186,223,0,0,18409
"058","Roma",21,19704,75,0,1,19780,18227,453,3,1,18684
"058","Roma",22,19591,156,2,2,19751,17613,775,9,0,18397
"058","Roma",23,19769,305,0,3,20077,17800,1232,16,4,19052
"058","Roma",24,19035,527,3,2,19567,17221,1816,16,7,19060
"058","Roma",25,18796,868,6,0,19670,16436,2550,24,1,19011
"058","Roma",26,19162,1327,6,1,20496,16841,3375,42,12,20270
"058","Roma",27,19288,2003,7,4,21302,16223,4540,56,13,20832
"058","Roma",28,19114,2873,13,4,22004,15730,5693,78,13,21514
"058","Roma",29,18738,3999,21,4,22762,15352,7321,91,15,22779
"058","Roma",30,17798,5095,24,3,22920,14336,8909,142,32,23419
"058","Roma",31,17078,6682,49,4,23813,13781,10367,205,39,24392
"058","Roma",32,16529,8126,72,5,24732,13256,12066,284,52,25658
"058","Roma",33,16795,9654,77,10,26536,13156,14106,373,70,27705
"058","Roma",34,16053,11268,131,7,27459,12698,15501,478,80,28757
"058","Roma",35,15359,12925,198,14,28496,12597,17162,623,96,30478
"058","Roma",36,15392,14725,264,26,30407,12422,19051,762,135,32370
"058","Roma",37,15298,16323,353,21,31995,12333,20988,980,134,34435
"058","Roma",38,14279,17837,454,32,32602,11619,21836,1113,166,34734
"058","Roma",39,13502,18866,586,30,32984,10926,22928,1220,195,35269
"058","Roma",40,12455,20125,624,40,33244,10185,23494,1507,235,35421
"058","Roma",41,11678,20862,730,51,33321,9350,24079,1626,303,35358
"058","Roma",42,10906,21693,909,68,33576,9050,24728,1910,339,36027
"058","Roma",43,10035,21950,1086,81,33152,8450,24838,2049,413,35750
"058","Roma",44,9235,22614,1087,93,33029,8017,25209,2235,461,35922
"058","Roma",45,8930,23448,1252,110,33740,7533,25687,2228,540,35988
"058","Roma",46,8205,24059,1407,130,33801,7152,25875,2352,589,35968
"058","Roma",47,7812,24670,1516,147,34145,6691,26771,2556,736,36754
"058","Roma",48,6634,23827,1495,168,32124,5983,25335,2457,809,34584
"058","Roma",49,5880,22889,1512,169,30450,5612,24239,2368,832,33051
"058","Roma",50,5473,22667,1445,224,29809,5145,23629,2319,952,32045
"058","Roma",51,4875,21524,1346,227,27972,4725,22584,2402,1080,30791
"058","Roma",52,4488,21016,1454,235,27193,4516,22127,2254,1104,30001
"058","Roma",53,4122,20347,1396,247,26112,4141,21256,2212,1232,28841
"058","Roma",54,3860,20125,1361,258,25604,3837,21114,2134,1331,28416
"058","Roma",55,3580,19886,1326,309,25101,3480,20561,2113,1489,27643
"058","Roma",56,3198,19649,1242,312,24401,3470,20109,2015,1649,27243
"058","Roma",57,2834,19129,1203,382,23548,3268,19848,1967,1753,26836
"058","Roma",58,2693,18164,1128,409,22394,2968,18814,1799,1844,25425
"058","Roma",59,2382,18000,1040,428,21850,2760,18233,1796,2071,24860
"058","Roma",60,2312,17775,946,422,21455,2649,17968,1681,2283,24581
"058","Roma",61,2256,18344,1000,544,22144,2549,18517,1710,2524,25300
"058","Roma",62,2019,18173,1015,580,21787,2462,18244,1591,2723,25020
"058","Roma",63,2110,19193,961,699,22963,2569,19420,1593,3263,26845
"058","Roma",64,1861,19572,922,810,23165,2435,19134,1576,3682,26827
"058","Roma",65,1863,19096,861,834,22654,2430,18716,1555,3988,26689
"058","Roma",66,1527,15218,674,726,18145,2035,14717,1192,3633,21577
"058","Roma",67,1394,15230,661,765,18050,2041,14276,1152,3916,21385
"058","Roma",68,1453,15839,672,914,18878,2117,14921,1170,4697,22905
"058","Roma",69,1399,15528,592,1046,18565,2070,14265,1109,4954,22398
"058","Roma",70,1347,15579,551,1108,18585,2076,13954,1036,5504,22570
"058","Roma",71,1374,16731,526,1276,19907,2312,14880,1068,6705,24965
"058","Roma",72,1268,16024,469,1355,19116,2114,13838,899,7054,23905
"058","Roma",73,1185,15228,452,1454,18319,2085,12708,842,7393,23028
"058","Roma",74,1068,13665,405,1483,16621,1975,11104,700,7619,21398
"058","Roma",75,954,12533,324,1441,15252,1873,9811,676,7599,19959
"058","Roma",76,924,12355,314,1593,15186,1843,9276,585,8282,19986
"058","Roma",77,874,11362,283,1673,14192,1854,8251,527,8687,19319
"058","Roma",78,749,10424,235,1631,13039,1775,7148,475,8946,18344
"058","Roma",79,665,9300,192,1668,11825,1707,6215,412,8837,17171
"058","Roma",80,624,8914,172,1705,11415,1622,5522,379,9222,16745
"058","Roma",81,591,8474,151,1745,10961,1708,5104,382,9877,17071
"058","Roma",82,533,6979,136,1631,9279,1483,3771,354,8830,14438
"058","Roma",83,498,5800,103,1606,8007,1382,3257,241,8645,13525
"058","Roma",84,394,5186,81,1602,7263,1342,2714,240,8528,12824
"058","Roma",85,403,4263,64,1491,6221,1296,2185,238,8046,11765
"058","Roma",86,306,3489,72,1336,5203,1120,1718,211,7308,10357
"058","Roma",87,278,2835,42,1368,4523,1040,1349,179,6717,9285
"058","Roma",88,266,2349,32,1189,3836,913,1069,153,6336,8471
"058","Roma",89,217,1803,25,1043,3088,775,767,130,5526,7198
"058","Roma",90,198,1429,24,917,2568,676,590,97,4920,6283
"058","Roma",91,156,1026,13,770,1965,548,442,70,4082,5142
"058","Roma",92,84,541,10,395,1030,363,171,44,2115,2693
"058","Roma",93,99,394,10,309,812,239,137,32,1428,1836
"058","Roma",94,67,240,2,222,531,209,97,27,1275,1608
"058","Roma",95,90,284,7,233,614,229,116,24,1416,1785
"058","Roma",96,63,154,2,170,389,218,97,19,1223,1557
"058","Roma",97,45,107,2,112,266,227,84,10,1003,1324
"058","Roma",98,41,65,2,68,176,162,70,15,776,1023
"058","Roma",99,30,34,1,50,115,80,44,5,338,467
"058","Roma",100,36,41,0,50,127,142,62,9,496,709
"059","Latina",0,2613,0,0,0,2613,2598,0,0,0,2598
"059","Latina",1,2692,0,0,0,2692,2548,0,0,0,2548
"059","Latina",2,2677,0,0,0,2677,2584,0,0,0,2584
"059","Latina",3,2633,0,0,0,2633,2581,0,0,0,2581
"059","Latina",4,2649,0,0,0,2649,2481,0,0,0,2481
"059","Latina",5,2634,0,0,0,2634,2548,0,0,0,2548
"059","Latina",6,2530,0,0,0,2530,2513,0,0,0,2513
"059","Latina",7,2566,0,0,0,2566,2420,0,0,0,2420
"059","Latina",8,2617,0,0,0,2617,2517,0,0,0,2517
"059","Latina",9,2570,0,0,0,2570,2445,0,0,0,2445
"059","Latina",10,2615,0,0,0,2615,2479,0,0,0,2479
"059","Latina",11,2779,0,0,0,2779,2505,0,0,0,2505
"059","Latina",12,2697,0,0,0,2697,2519,0,0,0,2519
"059","Latina",13,2619,0,0,0,2619,2407,0,0,0,2407
"059","Latina",14,2712,0,0,0,2712,2586,0,0,0,2586
"059","Latina",15,2752,0,0,0,2752,2600,0,0,0,2600
"059","Latina",16,2855,0,0,0,2855,2598,0,0,0,2598
"059","Latina",17,2868,0,0,0,2868,2646,1,0,0,2647
"059","Latina",18,2958,0,0,0,2958,2776,8,0,0,2784
"059","Latina",19,3025,1,0,0,3026,2858,26,0,0,2884
"059","Latina",20,2976,8,0,0,2984,2824,56,0,0,2880
"059","Latina",21,3104,15,0,0,3119,2836,106,0,0,2942
"059","Latina",22,3046,37,0,0,3083,2808,189,1,0,2998
"059","Latina",23,3112,70,1,0,3183,2779,298,1,2,3080
"059","Latina",24,3026,95,0,0,3121,2722,393,2,0,3117
"059","Latina",25,3144,195,0,0,3339,2485,526,5,1,3017
"059","Latina",26,3009,232,1,0,3242,2537,715,1,0,3253
"059","Latina",27,3034,407,0,1,3442,2328,876,12,3,3219
"059","Latina",28,2842,545,1,3,3391,2100,1142,6,2,3250
"059","Latina",29,2785,769,4,0,3558,1984,1458,7,4,3453
"059","Latina",30,2657,912,3,1,3573,1911,1639,22,4,3576
"059","Latina",31,2397,1189,2,0,3588,1588,1889,23,7,3507
"059","Latina",32,2266,1409,6,1,3682,1445,2122,43,11,3621
"059","Latina",33,2198,1661,13,1,3873,1402,2392,38,13,3845
"059","Latina",34,2130,1886,13,0,4029,1349,2458,59,16,3882
"059","Latina",35,1921,2247,31,2,4201,1235,2758,74,14,4081
"059","Latina",36,1896,2386,35,4,4321,1210,3094,81,23,4408
"059","Latina",37,1706,2620,37,3,4366,1135,3190,86,20,4431
"059","Latina",38,1673,2710,52,4,4439,1011,3379,107,24,4521
"059","Latina",39,1519,2815,69,4,4407,943,3437,132,36,4548
"059","Latina",40,1398,2905,73,6,4382,869,3493,147,45,4554
"059","Latina",41,1225,3112,82,7,4426,742,3485,148,40,4415
"059","Latina",42,1100,3181,95,11,4387,647,3710,162,44,4563
"059","Latina",43,1031,3216,107,16,4370,638,3684,189,66,4577
"059","Latina",44,934,3422,106,12,4474,624,3640,170,73,4507
"059","Latina",45,798,3539,134,13,4484,599,3758,198,89,4644
"059","Latina",46,808,3507,125,25,4465,582,3686,198,74,4540
"059","Latina",47,741,3480,133,16,4370,519,3824,190,120,4653
"059","Latina",48,633,3359,148,16,4156,465,3531,180,107,4283
"059","Latina",49,538,3266,125,23,3952,425,3462,170,120,4177
"059","Latina",50,484,3267,123,22,3896,400,3453,169,140,4162
"059","Latina",51,439,3147,113,26,3725,366,3266,158,183,3973
"059","Latina",52,405,3120,124,31,3680,340,3188,173,165,3866
"059","Latina",53,381,2949,124,37,3491,336,2961,152,175,3624
"059","Latina",54,369,2964,108,42,3483,256,3062,125,223,3666
"059","Latina",55,310,2915,95,45,3365,281,2935,132,218,3566
"059","Latina",56,254,2928,105,45,3332,265,2972,121,224,3582
"059","Latina",57,256,3022,99,52,3429,228,3023,102,296,3649
"059","Latina",58,235,2780,76,52,3143,206,2677,85,298,3266
"059","Latina",59,193,2748,85,57,3083,197,2664,93,316,3270
"059","Latina",60,205,2819,78,60,3162,203,2787,100,346,3436
"059","Latina",61,187,2877,87,83,3234,214,2865,104,420,3603
"059","Latina",62,220,3000,97,81,3398,220,2898,94,438,3650
"059","Latina",63,216,3251,79,120,3666,221,2974,85,549,3829
"059","Latina",64,215,3248,70,119,3652,187,2805,86,599,3677
"059","Latina",65,173,2993,64,123,3353,183,2706,86,604,3579
"059","Latina",66,117,2057,39,88,2301,126,1803,49,469,2447
"059","Latina",67,111,2055,36,100,2302,135,1773,55,526,2489
"059","Latina",68,102,2199,40,123,2464,130,1952,37,639,2758
"059","Latina",69,112,2130,43,122,2407,146,1833,41,654,2674
"059","Latina",70,115,2141,32,127,2415,152,1749,37,735,2673
"059","Latina",71,128,2354,37,196,2715,165,1832,42,875,2914
"059","Latina",72,128,2203,42,195,2568,146,1733,45,888,2812
"059","Latina",73,92,2087,24,157,2360,135,1605,24,984,2748
"059","Latina",74,100,1913,21,184,2218,145,1417,31,985,2578
"059","Latina",75,77,1749,25,182,2033,131,1223,24,987,2365
"059","Latina",76,88,1781,19,202,2090,117,1149,26,1127,2419
"059","Latina",77,71,1567,26,210,1874,142,989,28,1107,2266
"059","Latina",78,59,1372,14,188,1633,128,879,24,1108,2139
"059","Latina",79,54,1275,5,188,1522,110,801,12,1089,2012
"059","Latina",80,52,1196,16,216,1480,109,681,25,1160,1975
"059","Latina",81,47,1087,5,223,1362,155,596,13,1190,1954
"059","Latina",82,48,935,6,231,1220,117,486,18,1131,1752
"059","Latina",83,42,795,7,221,1065,111,400,7,1074,1592
"059","Latina",84,25,644,8,207,884,110,286,12,1048,1456
"059","Latina",85,33,523,6,201,763,81,280,7,1007,1375
"059","Latina",86,26,452,2,187,667,84,193,2,855,1134
"059","Latina",87,14,388,4,177,583,83,152,9,873,1117
"059","Latina",88,20,295,6,200,521,84,132,6,808,1030
"059","Latina",89,17,220,2,140,379,48,97,7,669,821
"059","Latina",90,14,177,7,120,318,45,64,7,590,706
"059","Latina",91,8,165,1,119,293,42,48,5,548,643
"059","Latina",92,9,71,0,58,138,27,30,0,279,336
"059","Latina",93,3,41,0,38,82,18,17,0,169,204
"059","Latina",94,3,35,0,16,54,15,17,0,166,198
"059","Latina",95,5,37,0,36,78,14,12,0,126,152
"059","Latina",96,3,20,0,30,53,14,8,1,154,177
"059","Latina",97,1,18,1,18,38,6,4,0,82,92
"059","Latina",98,1,7,1,12,21,4,4,1,73,82
"059","Latina",99,4,8,0,8,20,4,3,0,37,44
"059","Latina",100,0,8,1,13,22,3,2,0,60,65
"060","Frosinone",0,2056,0,0,0,2056,1979,0,0,0,1979
"060","Frosinone",1,2197,0,0,0,2197,2088,0,0,0,2088
"060","Frosinone",2,2202,0,0,0,2202,2009,0,0,0,2009
"060","Frosinone",3,2144,0,0,0,2144,2116,0,0,0,2116
"060","Frosinone",4,2241,0,0,0,2241,2050,0,0,0,2050
"060","Frosinone",5,2100,0,0,0,2100,2056,0,0,0,2056
"060","Frosinone",6,2116,0,0,0,2116,2036,0,0,0,2036
"060","Frosinone",7,2209,0,0,0,2209,2036,0,0,0,2036
"060","Frosinone",8,2156,0,0,0,2156,2099,0,0,0,2099
"060","Frosinone",9,2143,0,0,0,2143,2061,0,0,0,2061
"060","Frosinone",10,2193,0,0,0,2193,1951,0,0,0,1951
"060","Frosinone",11,2296,0,0,0,2296,2079,0,0,0,2079
"060","Frosinone",12,2222,0,0,0,2222,2078,0,0,0,2078
"060","Frosinone",13,2173,0,0,0,2173,2123,0,0,0,2123
"060","Frosinone",14,2362,0,0,0,2362,2146,0,0,0,2146
"060","Frosinone",15,2314,0,0,0,2314,2233,0,0,0,2233
"060","Frosinone",16,2432,0,0,0,2432,2240,0,0,0,2240
"060","Frosinone",17,2537,0,0,0,2537,2376,1,0,0,2377
"060","Frosinone",18,2553,1,0,0,2554,2431,8,0,0,2439
"060","Frosinone",19,2766,2,0,0,2768,2652,34,0,0,2686
"060","Frosinone",20,2825,4,0,0,2829,2624,66,0,0,2690
"060","Frosinone",21,2847,10,0,0,2857,2577,125,1,0,2703
"060","Frosinone",22,2941,48,0,0,2989,2631,192,0,0,2823
"060","Frosinone",23,2926,68,0,0,2994,2567,279,1,0,2847
"060","Frosinone",24,2882,108,0,0,2990,2491,348,3,0,2842
"060","Frosinone",25,2809,150,0,0,2959,2452,489,1,2,2944
"060","Frosinone",26,2918,238,1,0,3157,2258,642,5,1,2906
"060","Frosinone",27,2857,344,0,0,3201,2198,873,6,3,3080
"060","Frosinone",28,2759,544,1,0,3304,2061,1083,11,3,3158
"060","Frosinone",29,2620,708,1,0,3329,1793,1302,7,4,3106
"060","Frosinone",30,2354,875,0,1,3230,1762,1487,13,3,3265
"060","Frosinone",31,2215,1067,3,0,3285,1474,1753,29,4,3260
"060","Frosinone",32,2026,1267,6,0,3299,1366,1915,34,11,3326
"060","Frosinone",33,1914,1494,6,2,3416,1271,2061,34,12,3378
"060","Frosinone",34,1775,1667,12,0,3454,1149,2201,35,18,3403
"060","Frosinone",35,1677,1874,17,2,3570,1062,2415,54,15,3546
"060","Frosinone",36,1557,2095,28,2,3682,962,2511,89,20,3582
"060","Frosinone",37,1468,2247,35,8,3758,895,2759,70,21,3745
"060","Frosinone",38,1267,2269,41,2,3579,819,2696,81,27,3623
"060","Frosinone",39,1158,2272,36,1,3467,708,2888,106,30,3732
"060","Frosinone",40,1053,2553,56,6,3668,670,2882,107,36,3695
"060","Frosinone",41,950,2593,51,7,3601,606,2911,106,33,3656
"060","Frosinone",42,915,2729,69,10,3723,576,3148,104,39,3867
"060","Frosinone",43,817,2743,69,10,3639,511,3070,111,57,3749
"060","Frosinone",44,741,2880,77,15,3713,478,3201,135,61,3875
"060","Frosinone",45,647,2911,88,12,3658,442,3224,112,69,3847
"060","Frosinone",46,568,3052,81,5,3706,406,3283,118,73,3880
"060","Frosinone",47,540,3089,102,12,3743,393,3403,123,93,4012
"060","Frosinone",48,502,2929,96,20,3547,337,3165,131,85,3718
"060","Frosinone",49,471,2959,112,21,3563,334,3177,125,137,3773
"060","Frosinone",50,418,2904,84,18,3424,366,3058,114,137,3675
"060","Frosinone",51,403,3005,78,28,3514,272,3114,100,160,3646
"060","Frosinone",52,402,2870,97,34,3403,247,3044,117,167,3575
"060","Frosinone",53,330,2842,71,41,3284,256,2970,121,211,3558
"060","Frosinone",54,353,2909,87,43,3392,244,2851,100,227,3422
"060","Frosinone",55,315,2827,74,49,3265,204,2830,91,213,3338
"060","Frosinone",56,284,2958,86,41,3369,194,2882,112,263,3451
"060","Frosinone",57,254,2887,79,41,3261,216,2815,89,281,3401
"060","Frosinone",58,248,2775,60,60,3143,215,2654,80,287,3236
"060","Frosinone",59,238,2793,53,43,3127,204,2566,66,318,3154
"060","Frosinone",60,210,2858,53,56,3177,174,2599,55,361,3189
"060","Frosinone",61,185,2843,63,69,3160,172,2577,52,433,3234
"060","Frosinone",62,181,2987,78,89,3335,155,2632,71,431,3289
"060","Frosinone",63,201,3069,65,106,3441,179,2686,62,527,3454
"060","Frosinone",64,180,2997,64,93,3334,175,2560,54,540,3329
"060","Frosinone",65,151,2650,57,112,2970,164,2368,48,569,3149
"060","Frosinone",66,111,1853,26,59,2049,87,1515,43,422,2067
"060","Frosinone",67,117,1993,32,105,2247,123,1679,37,527,2366
"060","Frosinone",68,103,2039,26,101,2269,138,1646,34,572,2390
"060","Frosinone",69,116,1838,23,106,2083,109,1501,25,584,2219
"060","Frosinone",70,85,1809,22,114,2030,122,1481,29,649,2281
"060","Frosinone",71,118,2174,34,141,2467,113,1579,27,760,2479
"060","Frosinone",72,111,2112,25,166,2414,112,1620,26,927,2685
"060","Frosinone",73,89,1958,24,166,2237,133,1474,16,980,2603
"060","Frosinone",74,90,1803,16,192,2101,118,1308,18,965,2409
"060","Frosinone",75,90,1646,15,175,1926,103,1256,20,972,2351
"060","Frosinone",76,90,1656,12,194,1952,116,1206,18,1076,2416
"060","Frosinone",77,78,1515,10,218,1821,128,1131,24,1122,2405
"060","Frosinone",78,60,1493,11,231,1795,122,982,15,1156,2275
"060","Frosinone",79,51,1263,7,224,1545,113,916,10,1187,2226
"060","Frosinone",80,64,1246,8,251,1569,137,768,16,1300,2221
"060","Frosinone",81,58,1200,12,282,1552,147,759,8,1314,2228
"060","Frosinone",82,41,1049,4,243,1337,135,600,15,1231,1981
"060","Frosinone",83,44,837,7,229,1117,135,474,12,1235,1856
"060","Frosinone",84,42,681,4,251,978,105,446,10,1208,1769
"060","Frosinone",85,32,616,2,264,914,93,386,8,1133,1620
"060","Frosinone",86,28,513,2,221,764,91,290,5,991,1377
"060","Frosinone",87,26,424,0,226,676,100,266,4,1033,1403
"060","Frosinone",88,21,343,2,240,606,96,203,6,901,1206
"060","Frosinone",89,13,276,2,194,485,77,161,4,850,1092
"060","Frosinone",90,17,199,0,156,372,68,92,2,683,845
"060","Frosinone",91,11,208,1,147,367,62,96,3,659,820
"060","Frosinone",92,3,68,3,67,141,44,41,0,289,374
"060","Frosinone",93,2,35,0,45,82,14,19,0,194,227
"060","Frosinone",94,2,33,2,34,71,23,15,2,160,200
"060","Frosinone",95,4,34,0,37,75,11,13,1,150,175
"060","Frosinone",96,1,24,0,44,69,14,11,1,137,163
"060","Frosinone",97,0,14,0,29,43,10,11,0,124,145
"060","Frosinone",98,2,7,0,24,33,10,6,0,89,105
"060","Frosinone",99,1,11,0,10,22,4,5,0,53,62
"060","Frosinone",100,0,1,0,25,26,7,2,0,80,89
"061","Caserta",0,4664,0,0,0,4664,4323,0,0,0,4323
"061","Caserta",1,4758,0,0,0,4758,4736,0,0,0,4736
"061","Caserta",2,4949,0,0,0,4949,4655,0,0,0,4655
"061","Caserta",3,4943,0,0,0,4943,4725,0,0,0,4725
"061","Caserta",4,5043,0,0,0,5043,4799,0,0,0,4799
"061","Caserta",5,5047,0,0,0,5047,4877,0,0,0,4877
"061","Caserta",6,5161,0,0,0,5161,4770,0,0,0,4770
"061","Caserta",7,5373,0,0,0,5373,5057,0,0,0,5057
"061","Caserta",8,5319,0,0,0,5319,5058,0,0,0,5058
"061","Caserta",9,5201,0,0,0,5201,5048,0,0,0,5048
"061","Caserta",10,5400,0,0,0,5400,5160,0,0,0,5160
"061","Caserta",11,5292,0,0,0,5292,5156,0,0,0,5156
"061","Caserta",12,5343,0,0,0,5343,5119,0,0,0,5119
"061","Caserta",13,5405,0,0,0,5405,5132,0,0,0,5132
"061","Caserta",14,5549,0,0,0,5549,5219,0,0,0,5219
"061","Caserta",15,5520,0,0,0,5520,5225,0,0,0,5225
"061","Caserta",16,5599,1,0,0,5600,5412,3,0,0,5415
"061","Caserta",17,5772,0,0,0,5772,5449,3,0,0,5452
"061","Caserta",18,5869,1,0,0,5870,5523,33,0,0,5556
"061","Caserta",19,6128,9,0,0,6137,5791,75,0,0,5866
"061","Caserta",20,6275,50,2,0,6327,5813,190,5,0,6008
"061","Caserta",21,6101,84,0,0,6185,5583,323,2,0,5908
"061","Caserta",22,5920,124,1,0,6045,5505,484,10,2,6001
"061","Caserta",23,5887,189,2,0,6078,5178,725,11,0,5914
"061","Caserta",24,5685,294,2,0,5981,4878,998,9,1,5886
"061","Caserta",25,5539,408,3,0,5950,4582,1364,19,2,5967
"061","Caserta",26,5289,662,7,0,5958,4188,1715,13,5,5921
"061","Caserta",27,5172,919,7,0,6098,3800,2296,14,3,6113
"061","Caserta",28,4839,1319,17,0,6175,3398,2864,15,2,6279
"061","Caserta",29,4544,1712,6,1,6263,3011,3338,22,9,6380
"061","Caserta",30,3934,2206,12,0,6152,2431,3561,25,9,6026
"061","Caserta",31,3429,2673,19,1,6122,2158,4085,28,20,6291
"061","Caserta",32,3228,3147,17,2,6394,1994,4489,43,17,6543
"061","Caserta",33,2949,3579,23,1,6552,1690,4804,54,16,6564
"061","Caserta",34,2635,3847,32,8,6522,1541,4934,58,19,6552
"061","Caserta",35,2416,4301,31,7,6755,1409,5354,79,43,6885
"061","Caserta",36,2235,4697,41,3,6976,1334,5398,96,45,6873
"061","Caserta",37,2081,4974,44,5,7104,1300,5799,90,42,7231
"061","Caserta",38,1801,5012,29,13,6855,1180,5838,111,57,7186
"061","Caserta",39,1605,5049,32,10,6696,1161,5796,116,62,7135
"061","Caserta",40,1558,5307,65,11,6941,1066,5907,123,93,7189
"061","Caserta",41,1377,5464,56,16,6913,1031,5775,128,83,7017
"061","Caserta",42,1281,5630,72,15,6998,941,6019,147,110,7217
"061","Caserta",43,1221,5696,70,20,7007,966,6083,126,142,7317
"061","Caserta",44,1109,5960,75,23,7167,889,6123,146,136,7294
"061","Caserta",45,1013,5880,82,37,7012,982,6015,183,160,7340
"061","Caserta",46,988,6081,81,41,7191,880,6160,164,164,7368
"061","Caserta",47,817,6300,100,38,7255,864,6271,161,204,7500
"061","Caserta",48,776,5765,86,32,6659,830,5790,147,205,6972
"061","Caserta",49,680,5588,97,38,6403,776,5488,160,277,6701
"061","Caserta",50,639,5518,82,49,6288,725,5564,140,293,6722
"061","Caserta",51,576,5301,80,53,6010,696,5199,130,309,6334
"061","Caserta",52,462,5348,57,51,5918,683,5025,142,329,6179
"061","Caserta",53,488,5023,78,51,5640,639,4758,148,344,5889
"061","Caserta",54,424,4915,76,76,5491,555,4609,117,366,5647
"061","Caserta",55,359,4746,85,73,5263,500,4564,122,419,5605
"061","Caserta",56,375,4905,64,86,5430,500,4491,125,499,5615
"061","Caserta",57,329,4869,63,89,5350,525,4641,130,556,5852
"061","Caserta",58,282,4338,58,91,4769,425,3956,107,491,4979
"061","Caserta",59,293,4237,41,98,4669,434,3722,77,587,4820
"061","Caserta",60,253,4377,56,117,4803,381,3821,95,603,4900
"061","Caserta",61,201,4492,58,142,4893,382,3985,99,705,5171
"061","Caserta",62,238,4328,46,127,4739,366,3941,79,793,5179
"061","Caserta",63,188,4447,44,177,4856,382,3910,106,831,5229
"061","Caserta",64,198,4295,50,175,4718,352,3634,97,928,5011
"061","Caserta",65,207,4371,43,204,4825,331,3582,85,1172,5170
"061","Caserta",66,155,3490,40,186,3871,287,2874,65,937,4163
"061","Caserta",67,151,2967,34,192,3344,275,2363,44,922,3604
"061","Caserta",68,155,3204,42,181,3582,324,2635,47,1090,4096
"061","Caserta",69,147,2986,29,222,3384,285,2353,50,1104,3792
"061","Caserta",70,128,2743,35,215,3121,307,2291,45,1220,3863
"061","Caserta",71,132,3078,30,297,3537,300,2448,46,1431,4225
"061","Caserta",72,102,2965,28,313,3408,337,2193,44,1502,4076
"061","Caserta",73,96,2596,34,338,3064,290,1961,36,1538,3825
"061","Caserta",74,104,2418,18,338,2878,267,1731,39,1504,3541
"061","Caserta",75,101,2156,15,317,2589,270,1594,39,1633,3536
"061","Caserta",76,82,2210,12,348,2652,270,1496,36,1637,3439
"061","Caserta",77,83,1848,7,368,2306,254,1289,33,1655,3231
"061","Caserta",78,72,1747,13,422,2254,285,1114,32,1699,3130
"061","Caserta",79,71,1601,11,399,2082,228,1021,25,1761,3035
"061","Caserta",80,62,1413,5,403,1883,247,939,26,1730,2942
"061","Caserta",81,64,1320,9,428,1821,269,816,36,1776,2897
"061","Caserta",82,48,1065,6,377,1496,224,630,20,1600,2474
"061","Caserta",83,42,922,4,354,1322,212,508,18,1557,2295
"061","Caserta",84,45,735,7,328,1115,230,433,14,1499,2176
"061","Caserta",85,43,635,5,345,1028,204,358,9,1377,1948
"061","Caserta",86,31,486,2,305,824,182,265,16,1179,1642
"061","Caserta",87,19,365,3,264,651,145,203,12,1086,1446
"061","Caserta",88,25,288,3,243,559,159,136,10,971,1276
"061","Caserta",89,18,225,2,212,457,118,97,6,801,1022
"061","Caserta",90,19,185,1,175,380,98,79,9,706,892
"061","Caserta",91,11,112,0,156,279,89,61,2,568,720
"061","Caserta",92,6,57,1,79,143,57,22,2,288,369
"061","Caserta",93,7,35,0,40,82,38,12,2,197,249
"061","Caserta",94,5,24,1,41,71,32,13,0,179,224
"061","Caserta",95,3,20,1,38,62,21,4,0,140,165
"061","Caserta",96,4,19,0,34,57,20,7,1,144,172
"061","Caserta",97,4,17,0,30,51,19,3,0,77,99
"061","Caserta",98,2,2,0,27,31,17,5,0,72,94
"061","Caserta",99,5,4,0,13,22,8,1,0,49,58
"061","Caserta",100,1,5,0,14,20,15,3,0,58,76
"062","Benevento",0,1184,0,0,0,1184,1052,0,0,0,1052
"062","Benevento",1,1145,0,0,0,1145,1140,0,0,0,1140
"062","Benevento",2,1215,0,0,0,1215,1172,0,0,0,1172
"062","Benevento",3,1225,0,0,0,1225,1157,0,0,0,1157
"062","Benevento",4,1231,0,0,0,1231,1245,0,0,0,1245
"062","Benevento",5,1256,0,0,0,1256,1152,0,0,0,1152
"062","Benevento",6,1307,0,0,0,1307,1205,0,0,0,1205
"062","Benevento",7,1367,0,0,0,1367,1210,0,0,0,1210
"062","Benevento",8,1356,0,0,0,1356,1244,0,0,0,1244
"062","Benevento",9,1363,0,0,0,1363,1330,0,0,0,1330
"062","Benevento",10,1355,0,0,0,1355,1322,0,0,0,1322
"062","Benevento",11,1484,0,0,0,1484,1396,0,0,0,1396
"062","Benevento",12,1384,0,0,0,1384,1372,0,0,0,1372
"062","Benevento",13,1420,0,0,0,1420,1426,0,0,0,1426
"062","Benevento",14,1435,0,0,0,1435,1449,0,0,0,1449
"062","Benevento",15,1527,0,0,0,1527,1432,0,0,0,1432
"062","Benevento",16,1559,0,0,0,1559,1429,0,0,0,1429
"062","Benevento",17,1672,0,0,0,1672,1523,1,0,0,1524
"062","Benevento",18,1641,0,0,0,1641,1603,6,0,0,1609
"062","Benevento",19,1771,0,0,0,1771,1655,13,0,0,1668
"062","Benevento",20,1841,2,0,0,1843,1620,25,2,0,1647
"062","Benevento",21,1808,9,0,0,1817,1697,56,0,0,1753
"062","Benevento",22,1776,22,0,0,1798,1607,84,2,4,1697
"062","Benevento",23,1809,29,0,0,1838,1638,138,2,0,1778
"062","Benevento",24,1761,55,0,0,1816,1494,210,2,1,1707
"062","Benevento",25,1678,86,2,0,1766,1399,289,0,1,1689
"062","Benevento",26,1659,133,0,0,1792,1359,344,2,1,1706
"062","Benevento",27,1615,207,0,0,1822,1285,437,7,1,1730
"062","Benevento",28,1516,241,1,0,1758,1166,576,10,0,1752
"062","Benevento",29,1498,305,0,0,1803,1056,678,5,4,1743
"062","Benevento",30,1346,454,2,0,1802,948,838,5,1,1792
"062","Benevento",31,1202,508,0,1,1711,814,915,9,1,1739
"062","Benevento",32,1115,684,4,1,1804,697,1079,10,4,1790
"062","Benevento",33,1022,729,5,1,1757,627,1164,13,6,1810
"062","Benevento",34,936,845,7,1,1789,612,1292,11,8,1923
"062","Benevento",35,904,1056,4,1,1965,538,1333,19,15,1905
"062","Benevento",36,824,1108,7,1,1940,438,1495,23,7,1963
"062","Benevento",37,731,1234,9,1,1975,437,1553,23,13,2026
"062","Benevento",38,702,1293,8,0,2003,413,1540,41,11,2005
"062","Benevento",39,638,1333,8,4,1983,354,1645,26,13,2038
"062","Benevento",40,544,1448,18,4,2014,314,1675,45,21,2055
"062","Benevento",41,497,1516,19,2,2034,293,1755,42,28,2118
"062","Benevento",42,498,1552,20,4,2074,342,1806,42,21,2211
"062","Benevento",43,471,1651,28,5,2155,288,1793,48,36,2165
"062","Benevento",44,413,1700,28,5,2146,277,1875,57,45,2254
"062","Benevento",45,388,1738,30,9,2165,296,1896,62,51,2305
"062","Benevento",46,347,1853,34,13,2247,254,1912,37,56,2259
"062","Benevento",47,376,1873,39,10,2298,268,1986,47,72,2373
"062","Benevento",48,301,1835,42,8,2186,253,1833,48,62,2196
"062","Benevento",49,284,1789,38,13,2124,202,1722,47,84,2055
"062","Benevento",50,253,1800,21,10,2084,209,1806,59,80,2154
"062","Benevento",51,232,1752,32,16,2032,196,1772,42,80,2090
"062","Benevento",52,207,1712,27,24,1970,178,1673,51,115,2017
"062","Benevento",53,196,1564,33,13,1806,175,1562,47,113,1897
"062","Benevento",54,178,1595,25,15,1813,160,1516,43,117,1836
"062","Benevento",55,141,1499,38,23,1701,142,1481,27,123,1773
"062","Benevento",56,162,1601,27,22,1812,141,1421,47,141,1750
"062","Benevento",57,139,1521,22,22,1704,124,1473,35,155,1787
"062","Benevento",58,128,1452,25,25,1630,116,1361,32,173,1682
"062","Benevento",59,99,1428,21,25,1573,125,1373,27,163,1688
"062","Benevento",60,130,1468,20,38,1656,106,1272,33,177,1588
"062","Benevento",61,105,1478,31,32,1646,112,1327,20,227,1686
"062","Benevento",62,108,1542,21,45,1716,100,1362,32,257,1751
"062","Benevento",63,104,1518,22,53,1697,120,1391,27,296,1834
"062","Benevento",64,111,1518,16,59,1704,113,1231,20,325,1689
"062","Benevento",65,90,1439,14,41,1584,98,1181,22,332,1633
"062","Benevento",66,58,1107,16,42,1223,82,918,10,278,1288
"062","Benevento",67,44,1040,11,54,1149,90,904,18,294,1306
"062","Benevento",68,60,1184,9,62,1315,98,941,13,352,1404
"062","Benevento",69,66,1010,12,60,1148,83,838,12,306,1239
"062","Benevento",70,57,972,8,83,1120,81,826,14,374,1295
"062","Benevento",71,75,1187,10,101,1373,127,962,16,513,1618
"062","Benevento",72,65,1193,12,95,1365,115,972,18,509,1614
"062","Benevento",73,53,1143,12,116,1324,95,822,13,550,1480
"062","Benevento",74,72,1096,3,122,1293,100,821,14,616,1551
"062","Benevento",75,59,998,9,116,1182,99,768,9,576,1452
"062","Benevento",76,43,990,8,137,1178,99,734,10,656,1499
"062","Benevento",77,49,885,9,155,1098,102,652,8,659,1421
"062","Benevento",78,48,856,8,149,1061,126,629,11,753,1519
"062","Benevento",79,39,816,4,161,1020,106,531,7,731,1375
"062","Benevento",80,44,722,1,153,920,124,513,6,807,1450
"062","Benevento",81,45,708,5,194,952,115,509,8,799,1431
"062","Benevento",82,29,601,3,167,800,102,386,11,706,1205
"062","Benevento",83,30,509,2,161,702,94,325,8,718,1145
"062","Benevento",84,32,466,3,214,715,108,286,4,829,1227
"062","Benevento",85,16,384,2,187,589,108,273,3,705,1089
"062","Benevento",86,25,344,3,180,552,102,216,3,695,1016
"062","Benevento",87,21,255,1,170,447,76,134,0,607,817
"062","Benevento",88,13,193,1,127,334,68,91,2,563,724
"062","Benevento",89,8,138,1,122,269,55,71,2,517,645
"062","Benevento",90,8,116,0,111,235,55,59,2,427,543
"062","Benevento",91,7,87,0,83,177,60,37,0,359,456
"062","Benevento",92,5,45,1,45,96,22,22,0,197,241
"062","Benevento",93,3,21,0,36,60,15,8,0,108,131
"062","Benevento",94,4,15,1,31,51,15,7,1,120,143
"062","Benevento",95,1,14,0,25,40,16,6,0,114,136
"062","Benevento",96,1,7,0,21,29,15,10,0,101,126
"062","Benevento",97,0,7,0,19,26,7,3,0,61,71
"062","Benevento",98,0,3,0,14,17,9,0,0,69,78
"062","Benevento",99,0,6,0,13,19,9,3,0,37,49
"062","Benevento",100,0,5,0,15,20,3,2,0,49,54
"063","Napoli",0,15891,0,0,0,15891,15075,0,0,0,15075
"063","Napoli",1,16510,0,0,0,16510,15165,0,0,0,15165
"063","Napoli",2,16566,0,0,0,16566,16122,0,0,0,16122
"063","Napoli",3,17043,0,0,0,17043,16173,0,0,0,16173
"063","Napoli",4,17346,0,0,0,17346,16697,0,0,0,16697
"063","Napoli",5,17833,0,0,0,17833,16519,0,0,0,16519
"063","Napoli",6,17725,0,0,0,17725,16782,0,0,0,16782
"063","Napoli",7,18251,0,0,0,18251,17155,0,0,0,17155
"063","Napoli",8,18363,0,0,0,18363,17586,0,0,0,17586
"063","Napoli",9,18175,0,0,0,18175,17381,0,0,0,17381
"063","Napoli",10,18743,0,0,0,18743,17540,0,0,0,17540
"063","Napoli",11,18898,0,0,0,18898,17887,0,0,0,17887
"063","Napoli",12,18762,0,0,0,18762,17899,0,0,0,17899
"063","Napoli",13,18850,0,0,0,18850,17835,0,0,0,17835
"063","Napoli",14,18789,0,0,0,18789,17895,0,0,0,17895
"063","Napoli",15,18989,0,0,0,18989,17980,0,0,0,17980
"063","Napoli",16,19009,1,0,0,19010,18554,3,0,0,18557
"063","Napoli",17,19590,1,0,0,19591,18865,17,0,0,18882
"063","Napoli",18,20132,8,0,0,20140,19285,143,0,0,19428
"063","Napoli",19,21035,73,0,0,21108,19951,443,0,1,20395
"063","Napoli",20,20896,157,1,0,21054,19498,834,3,1,20336
"063","Napoli",21,20502,337,0,0,20839,18870,1216,0,2,20088
"063","Napoli",22,20311,539,2,0,20852,18240,1936,5,2,20183
"063","Napoli",23,19872,927,1,0,20800,17781,2671,2,4,20458
"063","Napoli",24,18952,1284,2,0,20238,15892,3597,14,6,19509
"063","Napoli",25,17821,1891,1,0,19713,14830,4497,10,8,19345
"063","Napoli",26,17450,2768,5,1,20224,13520,6018,31,10,19579
"063","Napoli",27,16208,3596,6,1,19811,12426,7611,34,17,20088
"063","Napoli",28,14981,4831,9,2,19823,11024,9059,62,34,20179
"063","Napoli",29,14074,6253,21,1,20349,9785,10557,62,38,20442
"063","Napoli",30,12128,7141,15,6,19290,8551,11687,82,26,20346
"063","Napoli",31,11112,8673,32,5,19822,7181,12919,94,53,20247
"063","Napoli",32,9882,10036,40,9,19967,6445,14181,145,47,20818
"063","Napoli",33,9026,11202,49,7,20284,5845,15269,183,77,21374
"063","Napoli",34,8301,12559,77,7,20944,5309,16095,238,106,21748
"063","Napoli",35,7779,13663,112,10,21564,5202,16939,246,136,22523
"063","Napoli",36,7425,15156,113,19,22713,4884,17935,318,141,23278
"063","Napoli",37,6851,16279,167,26,23323,4871,19173,378,183,24605
"063","Napoli",38,6138,16399,152,28,22717,4353,19167,437,202,24159
"063","Napoli",39,5656,17192,210,36,23094,4034,19472,505,262,24273
"063","Napoli",40,5117,17145,246,48,22556,3876,19574,571,290,24311
"063","Napoli",41,4543,17220,252,44,22059,3584,19352,543,288,23767
"063","Napoli",42,4326,18057,293,56,22732,3453,19590,556,377,23976
"063","Napoli",43,3913,18113,289,67,22382,3251,19642,615,418,23926
"063","Napoli",44,3733,18597,346,66,22742,3335,20317,718,477,24847
"063","Napoli",45,3448,19235,355,93,23131,3157,20197,704,573,24631
"063","Napoli",46,3197,19178,427,97,22899,3039,20189,740,603,24571
"063","Napoli",47,3104,19733,435,118,23390,2988,20566,780,735,25069
"063","Napoli",48,2716,18563,373,140,21792,2887,19627,729,801,24044
"063","Napoli",49,2518,18401,414,136,21469,2750,19102,701,848,23401
"063","Napoli",50,2267,18042,356,158,20823,2549,18605,772,939,22865
"063","Napoli",51,2135,16963,398,191,19687,2382,17773,738,1052,21945
"063","Napoli",52,1859,17170,352,207,19588,2385,17375,696,1190,21646
"063","Napoli",53,1761,16441,357,223,18782,2293,16675,694,1254,20916
"063","Napoli",54,1649,16436,370,256,18711,2115,16533,677,1315,20640
"063","Napoli",55,1520,15938,301,283,18042,1903,15709,667,1504,19783
"063","Napoli",56,1366,16322,340,277,18305,1935,15790,591,1637,19953
"063","Napoli",57,1336,16152,304,325,18117,1885,15346,558,1877,19666
"063","Napoli",58,1201,14963,287,353,16804,1664,14128,542,1808,18142
"063","Napoli",59,1141,14577,264,384,16366,1693,13460,513,1928,17594
"063","Napoli",60,949,14561,261,428,16199,1595,13322,478,2181,17576
"063","Napoli",61,951,14831,247,461,16490,1657,13446,477,2305,17885
"063","Napoli",62,960,14929,225,511,16625,1594,13205,452,2596,17847
"063","Napoli",63,957,15167,230,643,16997,1638,13293,436,2943,18310
"063","Napoli",64,906,14666,241,671,16484,1631,12728,430,3175,17964
"063","Napoli",65,878,15157,195,739,16969,1570,12916,358,3717,18561
"063","Napoli",66,699,13087,168,743,14697,1427,10753,349,3504,16033
"063","Napoli",67,520,10303,141,642,11606,1124,8430,257,3118,12929
"063","Napoli",68,599,10814,132,768,12313,1243,8997,250,3672,14162
"063","Napoli",69,541,10361,137,795,11834,1307,8283,236,3805,13631
"063","Napoli",70,506,9603,124,851,11084,1234,7779,227,4143,13383
"063","Napoli",71,510,10006,111,931,11558,1333,7760,211,4626,13930
"063","Napoli",72,469,9279,97,987,10832,1190,7255,209,4796,13450
"063","Napoli",73,410,8423,100,1019,9952,1157,6484,174,4975,12790
"063","Napoli",74,386,7699,83,1069,9237,1090,5747,192,4906,11935
"063","Napoli",75,364,6799,71,1072,8306,998,4920,157,5006,11081
"063","Napoli",76,350,6445,54,1175,8024,1001,4677,146,5319,11143
"063","Napoli",77,317,5979,50,1140,7486,1038,4052,137,5269,10496
"063","Napoli",78,315,5475,46,1260,7096,1082,3710,119,5734,10645
"063","Napoli",79,293,5142,52,1292,6779,1006,3293,125,5723,10147
"063","Napoli",80,261,4569,45,1249,6124,1029,2815,113,5639,9596
"063","Napoli",81,247,4076,45,1325,5693,1046,2449,99,5924,9518
"063","Napoli",82,241,3379,40,1227,4887,927,2050,101,5094,8172
"063","Napoli",83,218,2941,27,1196,4382,844,1699,97,5148,7788
"063","Napoli",84,195,2361,17,1214,3787,825,1312,84,4775,6996
"063","Napoli",85,177,1885,15,991,3068,759,1000,58,4267,6084
"063","Napoli",86,139,1506,17,954,2616,697,842,65,3936,5540
"063","Napoli",87,135,1144,7,802,2088,596,623,50,3399,4668
"063","Napoli",88,119,945,9,676,1749,519,489,48,3047,4103
"063","Napoli",89,94,707,9,629,1439,493,383,26,2629,3531
"063","Napoli",90,78,508,8,486,1080,408,287,30,2226,2951
"063","Napoli",91,78,370,4,403,855,314,201,21,1834,2370
"063","Napoli",92,41,185,3,225,454,166,104,10,942,1222
"063","Napoli",93,34,107,2,111,254,154,72,10,747,983
"063","Napoli",94,46,115,1,166,328,128,48,5,589,770
"063","Napoli",95,33,77,1,81,192,140,54,9,538,741
"063","Napoli",96,26,58,1,90,175,92,42,6,420,560
"063","Napoli",97,17,27,2,48,94,76,39,7,294,416
"063","Napoli",98,12,18,1,32,63,51,22,5,203,281
"063","Napoli",99,11,18,0,26,55,44,17,2,155,218
"063","Napoli",100,7,14,0,29,50,53,13,1,168,235
"064","Avellino",0,1689,0,0,0,1689,1624,0,0,0,1624
"064","Avellino",1,1864,0,0,0,1864,1705,0,0,0,1705
"064","Avellino",2,1842,0,0,0,1842,1780,0,0,0,1780
"064","Avellino",3,1867,0,0,0,1867,1838,0,0,0,1838
"064","Avellino",4,1912,0,0,0,1912,1807,0,0,0,1807
"064","Avellino",5,1914,0,0,0,1914,1852,0,0,0,1852
"064","Avellino",6,1980,0,0,0,1980,1787,0,0,0,1787
"064","Avellino",7,2047,0,0,0,2047,1970,0,0,0,1970
"064","Avellino",8,2035,0,0,0,2035,1993,0,0,0,1993
"064","Avellino",9,2068,0,0,0,2068,1941,0,0,0,1941
"064","Avellino",10,2055,0,0,0,2055,1972,0,0,0,1972
"064","Avellino",11,2094,0,0,0,2094,2062,0,0,0,2062
"064","Avellino",12,2211,0,0,0,2211,2087,0,0,0,2087
"064","Avellino",13,2178,0,0,0,2178,2145,0,0,0,2145
"064","Avellino",14,2215,0,0,0,2215,2115,0,0,0,2115
"064","Avellino",15,2331,0,0,0,2331,2175,0,0,0,2175
"064","Avellino",16,2292,0,0,0,2292,2220,0,0,0,2220
"064","Avellino",17,2293,0,0,0,2293,2278,5,0,0,2283
"064","Avellino",18,2618,1,0,0,2619,2319,9,0,0,2328
"064","Avellino",19,2692,3,0,0,2695,2549,19,3,0,2571
"064","Avellino",20,2697,6,0,0,2703,2442,54,0,0,2496
"064","Avellino",21,2720,17,0,0,2737,2537,89,1,0,2627
"064","Avellino",22,2739,32,0,0,2771,2442,145,1,0,2588
"064","Avellino",23,2769,49,0,0,2818,2487,199,1,0,2687
"064","Avellino",24,2609,85,0,0,2694,2322,290,0,0,2612
"064","Avellino",25,2621,129,1,0,2751,2173,428,0,2,2603
"064","Avellino",26,2673,237,0,0,2910,2093,592,3,1,2689
"064","Avellino",27,2413,310,0,0,2723,1981,741,2,2,2726
"064","Avellino",28,2303,400,2,0,2705,1788,910,4,3,2705
"064","Avellino",29,2295,497,1,1,2794,1600,1037,8,2,2647
"064","Avellino",30,2102,710,2,0,2814,1373,1295,8,4,2680
"064","Avellino",31,1903,826,4,1,2734,1166,1387,13,1,2567
"064","Avellino",32,1786,1021,2,0,2809,1132,1521,21,4,2678
"064","Avellino",33,1527,1208,13,2,2750,978,1898,33,10,2919
"064","Avellino",34,1463,1408,8,0,2879,908,1955,21,5,2889
"064","Avellino",35,1340,1646,14,0,3000,819,2163,27,12,3021
"064","Avellino",36,1273,1730,17,0,3020,772,2285,39,11,3107
"064","Avellino",37,1198,1815,14,1,3028,680,2347,42,21,3090
"064","Avellino",38,975,1984,19,2,2980,611,2432,39,22,3104
"064","Avellino",39,940,2152,13,2,3107,525,2511,61,20,3117
"064","Avellino",40,827,2260,31,5,3123,555,2610,55,32,3252
"064","Avellino",41,763,2261,34,7,3065,488,2663,63,35,3249
"064","Avellino",42,789,2505,37,5,3336,499,2668,71,56,3294
"064","Avellino",43,686,2552,39,8,3285,490,2789,93,51,3423
"064","Avellino",44,645,2594,38,6,3283,459,2831,69,52,3411
"064","Avellino",45,617,2653,48,21,3339,429,2797,76,57,3359
"064","Avellino",46,561,2854,46,8,3469,412,2814,71,76,3373
"064","Avellino",47,554,2952,45,15,3566,416,3049,70,98,3633
"064","Avellino",48,512,2790,42,19,3363,397,2779,85,114,3375
"064","Avellino",49,476,2633,38,18,3165,340,2702,82,102,3226
"064","Avellino",50,416,2717,50,22,3205,351,2681,95,120,3247
"064","Avellino",51,393,2647,46,25,3111,365,2606,57,149,3177
"064","Avellino",52,373,2587,39,34,3033,349,2591,63,140,3143
"064","Avellino",53,323,2459,44,25,2851,279,2408,69,152,2908
"064","Avellino",54,305,2486,42,29,2862,283,2376,65,177,2901
"064","Avellino",55,252,2324,37,32,2645,263,2291,67,186,2807
"064","Avellino",56,247,2408,48,47,2750,229,2153,59,221,2662
"064","Avellino",57,213,2331,42,32,2618,227,2169,75,246,2717
"064","Avellino",58,225,2278,33,40,2576,225,2070,37,240,2572
"064","Avellino",59,206,2236,45,44,2531,211,2013,53,265,2542
"064","Avellino",60,202,2151,29,67,2449,196,1894,35,282,2407
"064","Avellino",61,173,2162,33,56,2424,194,1987,52,304,2537
"064","Avellino",62,164,2188,31,72,2455,196,1881,46,366,2489
"064","Avellino",63,163,2268,43,74,2548,200,1930,38,396,2564
"064","Avellino",64,143,2164,32,70,2409,198,1895,45,431,2569
"064","Avellino",65,144,2228,32,92,2496,175,1761,48,487,2471
"064","Avellino",66,128,1617,22,65,1832,125,1350,24,377,1876
"064","Avellino",67,92,1647,23,94,1856,130,1298,24,411,1863
"064","Avellino",68,121,1579,15,93,1808,146,1303,35,469,1953
"064","Avellino",69,84,1545,24,102,1755,130,1271,29,509,1939
"064","Avellino",70,103,1437,16,111,1667,142,1187,17,515,1861
"064","Avellino",71,106,1676,18,145,1945,154,1363,22,668,2207
"064","Avellino",72,103,1723,12,145,1983,165,1386,27,714,2292
"064","Avellino",73,110,1581,16,140,1847,145,1195,26,774,2140
"064","Avellino",74,85,1520,25,159,1789,182,1186,24,815,2207
"064","Avellino",75,79,1402,16,165,1662,152,1062,23,817,2054
"064","Avellino",76,77,1438,14,186,1715,128,1040,17,923,2108
"064","Avellino",77,90,1252,17,214,1573,143,955,15,922,2035
"064","Avellino",78,76,1249,13,252,1590,153,912,23,996,2084
"064","Avellino",79,63,1115,8,196,1382,141,771,11,996,1919
"064","Avellino",80,43,1095,7,230,1375,143,755,15,1068,1981
"064","Avellino",81,69,988,5,273,1335,170,716,8,1182,2076
"064","Avellino",82,46,873,10,257,1186,139,602,13,995,1749
"064","Avellino",83,45,733,5,253,1036,136,488,10,1044,1678
"064","Avellino",84,35,640,3,241,919,116,421,17,1011,1565
"064","Avellino",85,39,595,9,230,873,117,346,8,964,1435
"064","Avellino",86,36,395,5,231,667,125,270,11,933,1339
"064","Avellino",87,24,351,2,234,611,90,232,13,845,1180
"064","Avellino",88,15,302,1,195,513,83,189,3,771,1046
"064","Avellino",89,20,233,3,167,423,62,131,8,713,914
"064","Avellino",90,13,166,1,161,341,55,109,1,597,762
"064","Avellino",91,13,123,2,138,276,63,81,1,487,632
"064","Avellino",92,3,68,0,73,144,27,35,0,311,373
"064","Avellino",93,3,48,0,38,89,15,21,0,168,204
"064","Avellino",94,3,25,2,32,62,17,10,1,141,169
"064","Avellino",95,3,35,0,29,67,10,11,2,136,159
"064","Avellino",96,4,22,0,34,60,13,11,1,170,195
"064","Avellino",97,2,11,0,30,43,8,8,1,97,114
"064","Avellino",98,1,11,1,16,29,9,7,0,76,92
"064","Avellino",99,1,5,0,12,18,9,3,1,51,64
"064","Avellino",100,0,7,0,19,26,7,6,0,80,93
"065","Salerno",0,4899,0,0,0,4899,4608,0,0,0,4608
"065","Salerno",1,4993,0,0,0,4993,4667,0,0,0,4667
"065","Salerno",2,5159,0,0,0,5159,4855,0,0,0,4855
"065","Salerno",3,5077,0,0,0,5077,5006,0,0,0,5006
"065","Salerno",4,5157,0,0,0,5157,4974,0,0,0,4974
"065","Salerno",5,5271,0,0,0,5271,4987,0,0,0,4987
"065","Salerno",6,5292,0,0,0,5292,5168,0,0,0,5168
"065","Salerno",7,5500,0,0,0,5500,5216,0,0,0,5216
"065","Salerno",8,5517,0,0,0,5517,5365,0,0,0,5365
"065","Salerno",9,5506,0,0,0,5506,5238,0,0,0,5238
"065","Salerno",10,5751,0,0,0,5751,5392,0,0,0,5392
"065","Salerno",11,5965,0,0,0,5965,5435,0,0,0,5435
"065","Salerno",12,6018,0,0,0,6018,5506,0,0,0,5506
"065","Salerno",13,5813,0,0,0,5813,5470,0,0,0,5470
"065","Salerno",14,5867,0,0,0,5867,5456,0,0,0,5456
"065","Salerno",15,6077,0,0,0,6077,5794,0,0,0,5794
"065","Salerno",16,6029,0,0,3,6032,5795,0,0,0,5795
"065","Salerno",17,6164,0,0,0,6164,5774,3,0,0,5777
"065","Salerno",18,6588,2,0,0,6590,6269,23,0,0,6292
"065","Salerno",19,6978,12,0,0,6990,6503,64,2,0,6569
"065","Salerno",20,6870,27,1,1,6899,6425,178,0,0,6603
"065","Salerno",21,7031,66,2,0,7099,6540,272,2,0,6814
"065","Salerno",22,6978,93,1,0,7072,6238,422,1,0,6661
"065","Salerno",23,7065,143,0,0,7208,6416,690,3,0,7109
"065","Salerno",24,6783,266,0,0,7049,5872,959,3,6,6840
"065","Salerno",25,6634,402,1,1,7038,5619,1227,5,1,6852
"065","Salerno",26,6481,605,1,0,7087,5304,1571,6,3,6884
"065","Salerno",27,6351,881,2,1,7235,4956,2083,17,7,7063
"065","Salerno",28,5973,1199,3,0,7175,4359,2599,21,10,6989
"065","Salerno",29,5617,1560,7,1,7185,3959,3096,23,5,7083
"065","Salerno",30,5117,1995,12,1,7125,3433,3543,34,11,7021
"065","Salerno",31,4705,2353,8,1,7067,2932,3960,43,12,6947
"065","Salerno",32,4160,2927,18,0,7105,2677,4354,54,14,7099
"065","Salerno",33,4170,3260,19,4,7453,2396,4691,77,28,7192
"065","Salerno",34,3638,3757,24,6,7425,2168,5061,85,19,7333
"065","Salerno",35,3459,4202,29,6,7696,2038,5511,94,33,7676
"065","Salerno",36,3182,4619,43,9,7853,1911,5836,110,37,7894
"065","Salerno",37,3147,5057,42,11,8257,1793,6181,110,45,8129
"065","Salerno",38,2704,5308,65,10,8087,1583,6313,148,65,8109
"065","Salerno",39,2370,5410,72,5,7857,1503,6543,142,76,8264
"065","Salerno",40,2257,5834,72,14,8177,1400,6730,185,79,8394
"065","Salerno",41,2098,5768,76,17,7959,1373,6709,189,86,8357
"065","Salerno",42,1806,6244,90,17,8157,1355,6939,223,102,8619
"065","Salerno",43,1782,6298,114,16,8210,1221,7052,230,130,8633
"065","Salerno",44,1653,6512,102,27,8294,1203,7031,232,142,8608
"065","Salerno",45,1508,6678,127,25,8338,1195,7204,247,176,8822
"065","Salerno",46,1458,6770,137,27,8392,1111,7281,272,199,8863
"065","Salerno",47,1414,6997,139,48,8598,1134,7331,247,260,8972
"065","Salerno",48,1199,6589,144,37,7969,993,7103,261,234,8591
"065","Salerno",49,1124,6569,131,58,7882,980,7217,253,279,8729
"065","Salerno",50,998,6727,154,44,7923,948,6932,237,320,8437
"065","Salerno",51,966,6622,152,59,7799,913,6820,271,339,8343
"065","Salerno",52,826,6707,123,73,7729,886,6416,270,397,7969
"065","Salerno",53,752,6393,116,75,7336,741,6294,229,386,7650
"065","Salerno",54,719,6290,152,84,7245,743,6216,219,456,7634
"065","Salerno",55,575,6090,132,86,6883,706,5962,193,514,7375
"065","Salerno",56,622,6184,128,99,7033,659,5761,187,573,7180
"065","Salerno",57,551,5983,130,103,6767,622,5818,204,571,7215
"065","Salerno",58,484,5689,114,116,6403,595,5274,150,645,6664
"065","Salerno",59,435,5429,88,126,6078,496,4933,163,666,6258
"065","Salerno",60,432,5568,110,137,6247,499,5104,142,741,6486
"065","Salerno",61,414,5657,109,151,6331,520,4971,171,832,6494
"065","Salerno",62,353,5589,104,184,6230,503,5057,148,948,6656
"065","Salerno",63,393,5740,86,197,6416,526,5189,132,1072,6919
"065","Salerno",64,325,5517,96,212,6150,423,4852,101,1107,6483
"065","Salerno",65,298,5490,86,227,6101,426,4556,119,1131,6232
"065","Salerno",66,223,4089,75,198,4585,327,3378,88,944,4737
"065","Salerno",67,216,3684,52,186,4138,318,3159,79,1067,4623
"065","Salerno",68,232,4045,46,230,4553,394,3336,84,1257,5071
"065","Salerno",69,204,3932,63,252,4451,345,3275,69,1340,5029
"065","Salerno",70,207,3693,59,248,4207,354,2983,62,1394,4793
"065","Salerno",71,185,4246,57,318,4806,383,3280,76,1759,5498
"065","Salerno",72,196,4336,41,365,4938,395,3326,75,1936,5732
"065","Salerno",73,174,3776,48,381,4379,359,2882,49,1929,5219
"065","Salerno",74,173,3570,30,393,4166,358,2708,65,2041,5172
"065","Salerno",75,166,3191,38,431,3826,326,2517,47,2025,4915
"065","Salerno",76,166,3361,26,529,4082,356,2350,43,2309,5058
"065","Salerno",77,158,2951,22,492,3623,353,2194,42,2294,4883
"065","Salerno",78,142,2948,25,535,3650,368,1942,45,2539,4894
"065","Salerno",79,135,2647,14,511,3307,338,1714,40,2460,4552
"065","Salerno",80,146,2465,13,565,3189,316,1568,32,2515,4431
"065","Salerno",81,112,2378,9,601,3100,376,1510,32,2696,4614
"065","Salerno",82,86,1967,8,549,2610,317,1216,32,2526,4091
"065","Salerno",83,118,1579,10,504,2211,293,980,19,2536,3828
"065","Salerno",84,77,1393,11,549,2030,278,747,17,2308,3350
"065","Salerno",85,70,1128,12,507,1717,286,631,19,2065,3001
"065","Salerno",86,74,968,6,438,1486,227,559,31,2028,2845
"065","Salerno",87,44,805,4,395,1248,205,381,13,1829,2428
"065","Salerno",88,42,659,4,378,1083,200,287,12,1758,2257
"065","Salerno",89,30,454,3,375,862,171,190,11,1419,1791
"065","Salerno",90,20,327,1,278,626,130,155,7,1248,1540
"065","Salerno",91,13,247,1,217,478,115,97,2,927,1141
"065","Salerno",92,15,129,1,148,293,63,52,3,522,640
"065","Salerno",93,9,66,1,86,162,47,23,2,326,398
"065","Salerno",94,1,58,2,56,117,32,20,3,273,328
"065","Salerno",95,7,52,0,67,126,34,23,1,276,334
"065","Salerno",96,9,46,2,55,112,30,20,0,271,321
"065","Salerno",97,2,29,1,40,72,17,8,2,202,229
"065","Salerno",98,4,31,0,37,72,24,6,0,149,179
"065","Salerno",99,2,11,0,24,37,15,7,0,110,132
"065","Salerno",100,3,6,0,31,40,25,4,1,136,166
"066","L'Aquila",0,1272,0,0,0,1272,1202,0,0,0,1202
"066","L'Aquila",1,1257,0,0,0,1257,1225,0,0,0,1225
"066","L'Aquila",2,1231,0,0,0,1231,1180,0,0,0,1180
"066","L'Aquila",3,1282,0,0,0,1282,1133,0,0,0,1133
"066","L'Aquila",4,1251,0,0,0,1251,1170,0,0,0,1170
"066","L'Aquila",5,1205,0,0,0,1205,1118,0,0,0,1118
"066","L'Aquila",6,1178,0,0,0,1178,1212,0,0,0,1212
"066","L'Aquila",7,1288,0,0,0,1288,1126,0,0,0,1126
"066","L'Aquila",8,1244,0,0,0,1244,1138,0,0,0,1138
"066","L'Aquila",9,1184,0,0,0,1184,1118,0,0,0,1118
"066","L'Aquila",10,1245,0,0,0,1245,1210,0,0,0,1210
"066","L'Aquila",11,1321,0,0,0,1321,1178,0,0,0,1178
"066","L'Aquila",12,1281,0,0,0,1281,1248,0,0,0,1248
"066","L'Aquila",13,1259,0,0,0,1259,1214,0,0,0,1214
"066","L'Aquila",14,1229,0,0,0,1229,1218,0,0,0,1218
"066","L'Aquila",15,1288,0,0,0,1288,1298,0,0,0,1298
"066","L'Aquila",16,1335,0,0,0,1335,1321,0,0,0,1321
"066","L'Aquila",17,1427,0,0,0,1427,1352,0,0,0,1352
"066","L'Aquila",18,1475,1,0,0,1476,1341,5,0,0,1346
"066","L'Aquila",19,1509,4,0,0,1513,1405,18,0,0,1423
"066","L'Aquila",20,1544,4,0,0,1548,1489,57,0,0,1546
"066","L'Aquila",21,1635,12,0,0,1647,1457,71,0,0,1528
"066","L'Aquila",22,1671,19,0,0,1690,1438,90,1,0,1529
"066","L'Aquila",23,1655,43,0,0,1698,1430,179,2,0,1611
"066","L'Aquila",24,1632,58,0,0,1690,1424,197,1,0,1622
"066","L'Aquila",25,1683,85,0,0,1768,1413,250,2,0,1665
"066","L'Aquila",26,1691,98,1,0,1790,1428,342,4,0,1774
"066","L'Aquila",27,1661,182,2,0,1845,1316,447,6,1,1770
"066","L'Aquila",28,1594,265,1,0,1860,1317,452,5,1,1775
"066","L'Aquila",29,1616,338,2,0,1956,1282,697,7,2,1988
"066","L'Aquila",30,1562,457,1,0,2020,1085,762,9,3,1859
"066","L'Aquila",31,1406,560,4,2,1972,998,804,15,6,1823
"066","L'Aquila",32,1407,661,5,0,2073,941,964,16,4,1925
"066","L'Aquila",33,1309,799,7,0,2115,827,1103,17,3,1950
"066","L'Aquila",34,1207,864,9,2,2082,785,1114,20,11,1930
"066","L'Aquila",35,1201,999,7,1,2208,693,1242,25,3,1963
"066","L'Aquila",36,1097,1097,11,0,2205,693,1368,39,7,2107
"066","L'Aquila",37,1014,1211,11,1,2237,639,1539,58,14,2250
"066","L'Aquila",38,879,1120,21,6,2026,556,1522,60,11,2149
"066","L'Aquila",39,797,1290,34,7,2128,518,1611,61,13,2203
"066","L'Aquila",40,802,1386,30,2,2220,468,1612,62,18,2160
"066","L'Aquila",41,733,1401,36,5,2175,422,1600,81,22,2125
"066","L'Aquila",42,641,1566,46,6,2259,424,1641,83,22,2170
"066","L'Aquila",43,614,1613,42,5,2274,420,1755,72,31,2278
"066","L'Aquila",44,530,1594,56,8,2188,375,1806,81,31,2293
"066","L'Aquila",45,536,1656,58,15,2265,320,1849,91,40,2300
"066","L'Aquila",46,505,1725,59,6,2295,306,1896,87,46,2335
"066","L'Aquila",47,511,1873,67,9,2460,279,1916,104,62,2361
"066","L'Aquila",48,417,1751,66,7,2241,288,1928,114,74,2404
"066","L'Aquila",49,389,1780,78,14,2261,267,1863,77,59,2266
"066","L'Aquila",50,368,1755,68,18,2209,252,1879,87,69,2287
"066","L'Aquila",51,367,1763,67,13,2210,251,1851,93,79,2274
"066","L'Aquila",52,307,1757,68,15,2147,237,1852,81,96,2266
"066","L'Aquila",53,310,1684,73,16,2083,178,1778,86,92,2134
"066","L'Aquila",54,262,1721,62,26,2071,210,1724,101,120,2155
"066","L'Aquila",55,239,1793,71,33,2136,169,1671,81,133,2054
"066","L'Aquila",56,262,1748,69,29,2108,176,1669,70,161,2076
"066","L'Aquila",57,228,1796,59,26,2109,158,1712,76,161,2107
"066","L'Aquila",58,191,1679,71,20,1961,124,1577,86,181,1968
"066","L'Aquila",59,173,1630,57,36,1896,151,1542,61,206,1960
"066","L'Aquila",60,159,1590,47,28,1824,121,1528,76,199,1924
"066","L'Aquila",61,175,1699,50,46,1970,134,1470,48,217,1869
"066","L'Aquila",62,165,1632,59,57,1913,146,1652,51,236,2085
"066","L'Aquila",63,185,1747,41,55,2028,146,1588,55,314,2103
"066","L'Aquila",64,141,1707,34,61,1943,166,1475,42,326,2009
"066","L'Aquila",65,141,1561,44,56,1802,136,1344,38,293,1811
"066","L'Aquila",66,81,1109,24,37,1251,92,927,28,269,1316
"066","L'Aquila",67,94,1240,27,53,1414,97,1033,32,288,1450
"066","L'Aquila",68,103,1217,25,52,1397,97,1003,23,357,1480
"066","L'Aquila",69,127,1083,18,56,1284,88,957,25,357,1427
"066","L'Aquila",70,105,1108,15,75,1303,99,902,28,387,1416
"066","L'Aquila",71,112,1313,27,98,1550,117,1050,20,544,1731
"066","L'Aquila",72,120,1222,17,95,1454,109,997,24,529,1659
"066","L'Aquila",73,101,1117,17,72,1307,114,865,22,609,1610
"066","L'Aquila",74,106,1133,15,113,1367,107,899,20,587,1613
"066","L'Aquila",75,93,962,21,102,1178,121,738,15,605,1479
"066","L'Aquila",76,78,954,10,122,1164,103,756,27,639,1525
"066","L'Aquila",77,77,914,9,139,1139,105,676,14,737,1532
"066","L'Aquila",78,72,943,10,133,1158,111,670,14,798,1593
"066","L'Aquila",79,69,802,5,152,1028,106,567,12,786,1471
"066","L'Aquila",80,59,767,7,147,980,103,488,13,870,1474
"066","L'Aquila",81,64,793,6,183,1046,127,471,6,913,1517
"066","L'Aquila",82,47,654,3,164,868,116,426,6,833,1381
"066","L'Aquila",83,46,570,4,143,763,131,328,12,893,1364
"066","L'Aquila",84,39,517,5,198,759,98,288,9,896,1291
"066","L'Aquila",85,28,439,6,165,638,90,247,6,813,1156
"066","L'Aquila",86,25,376,7,173,581,99,184,7,799,1089
"066","L'Aquila",87,22,279,1,175,477,93,170,10,789,1062
"066","L'Aquila",88,34,245,2,143,424,75,119,3,667,864
"066","L'Aquila",89,20,196,3,124,343,64,84,3,605,756
"066","L'Aquila",90,13,160,1,106,280,60,66,5,528,659
"066","L'Aquila",91,17,113,1,100,231,45,53,2,468,568
"066","L'Aquila",92,2,73,0,51,126,26,25,1,233,285
"066","L'Aquila",93,3,33,0,31,67,19,11,0,154,184
"066","L'Aquila",94,3,22,0,24,49,12,4,0,135,151
"066","L'Aquila",95,5,24,0,38,67,13,6,1,137,157
"066","L'Aquila",96,3,22,0,19,44,7,4,0,148,159
"066","L'Aquila",97,5,4,0,22,31,11,1,0,89,101
"066","L'Aquila",98,1,4,0,12,17,6,3,0,70,79
"066","L'Aquila",99,0,5,0,10,15,7,0,1,49,57
"066","L'Aquila",100,1,3,0,15,19,6,0,0,63,69
"067","Teramo",0,1324,0,0,0,1324,1225,0,0,0,1225
"067","Teramo",1,1362,0,0,0,1362,1306,0,0,0,1306
"067","Teramo",2,1325,0,0,0,1325,1294,0,0,0,1294
"067","Teramo",3,1413,0,0,0,1413,1326,0,0,0,1326
"067","Teramo",4,1385,0,0,0,1385,1291,0,0,0,1291
"067","Teramo",5,1357,0,0,0,1357,1311,0,0,0,1311
"067","Teramo",6,1400,0,0,0,1400,1370,0,0,0,1370
"067","Teramo",7,1406,0,0,0,1406,1342,0,0,0,1342
"067","Teramo",8,1396,0,0,0,1396,1321,0,0,0,1321
"067","Teramo",9,1404,0,0,0,1404,1296,0,0,0,1296
"067","Teramo",10,1456,0,0,0,1456,1339,0,0,0,1339
"067","Teramo",11,1402,0,0,0,1402,1351,0,0,0,1351
"067","Teramo",12,1404,0,0,0,1404,1300,0,0,0,1300
"067","Teramo",13,1415,0,0,0,1415,1385,0,0,0,1385
"067","Teramo",14,1469,0,0,0,1469,1342,0,0,0,1342
"067","Teramo",15,1438,0,0,0,1438,1406,0,0,0,1406
"067","Teramo",16,1475,0,0,0,1475,1383,0,0,0,1383
"067","Teramo",17,1534,0,0,0,1534,1520,1,0,0,1521
"067","Teramo",18,1585,0,0,0,1585,1555,7,0,0,1562
"067","Teramo",19,1687,1,0,0,1688,1489,26,0,0,1515
"067","Teramo",20,1685,5,0,0,1690,1556,41,0,0,1597
"067","Teramo",21,1738,5,0,0,1743,1581,65,0,0,1646
"067","Teramo",22,1740,18,0,0,1758,1505,100,0,0,1605
"067","Teramo",23,1737,33,0,0,1770,1538,147,0,0,1685
"067","Teramo",24,1682,59,1,0,1742,1472,227,1,0,1700
"067","Teramo",25,1649,109,1,0,1759,1422,276,3,0,1701
"067","Teramo",26,1678,138,0,1,1817,1425,387,3,1,1816
"067","Teramo",27,1736,212,1,0,1949,1313,497,6,1,1817
"067","Teramo",28,1609,312,2,0,1923,1189,607,4,1,1801
"067","Teramo",29,1533,402,0,1,1936,1159,726,5,3,1893
"067","Teramo",30,1439,473,1,0,1913,1014,839,12,6,1871
"067","Teramo",31,1397,632,3,0,2032,938,926,12,3,1879
"067","Teramo",32,1292,679,5,0,1976,849,1118,13,6,1986
"067","Teramo",33,1212,841,6,1,2060,818,1252,18,2,2090
"067","Teramo",34,1160,951,7,2,2120,690,1310,36,4,2040
"067","Teramo",35,1042,1118,6,2,2168,647,1426,34,10,2117
"067","Teramo",36,1022,1145,12,3,2182,650,1476,34,11,2171
"067","Teramo",37,940,1307,15,1,2263,545,1668,55,14,2282
"067","Teramo",38,847,1406,21,0,2274,516,1740,53,9,2318
"067","Teramo",39,852,1505,29,2,2388,524,1781,54,12,2371
"067","Teramo",40,765,1573,34,3,2375,509,1838,77,27,2451
"067","Teramo",41,664,1602,36,5,2307,407,1966,60,24,2457
"067","Teramo",42,700,1747,32,5,2484,416,2007,95,29,2547
"067","Teramo",43,652,1791,45,7,2495,380,1941,90,30,2441
"067","Teramo",44,582,1940,38,7,2567,361,2024,76,45,2506
"067","Teramo",45,529,1945,66,12,2552,315,2126,76,44,2561
"067","Teramo",46,441,1932,62,12,2447,315,2155,108,57,2635
"067","Teramo",47,477,1971,53,14,2515,297,2094,104,55,2550
"067","Teramo",48,357,1880,67,11,2315,252,1992,91,61,2396
"067","Teramo",49,339,1824,64,14,2241,205,1904,76,62,2247
"067","Teramo",50,301,1778,82,8,2169,226,1873,89,59,2247
"067","Teramo",51,282,1774,58,13,2127,216,1833,87,75,2211
"067","Teramo",52,286,1804,55,25,2170,198,1893,84,83,2258
"067","Teramo",53,251,1696,64,18,2029,187,1767,81,94,2129
"067","Teramo",54,248,1690,56,19,2013,154,1715,71,117,2057
"067","Teramo",55,201,1694,64,27,1986,160,1695,52,122,2029
"067","Teramo",56,184,1664,40,20,1908,146,1631,69,140,1986
"067","Teramo",57,184,1684,45,31,1944,149,1639,55,159,2002
"067","Teramo",58,174,1500,56,23,1753,109,1522,58,155,1844
"067","Teramo",59,157,1521,48,29,1755,125,1445,52,178,1800
"067","Teramo",60,156,1554,28,28,1766,96,1502,55,197,1850
"067","Teramo",61,130,1597,33,38,1798,108,1548,46,242,1944
"067","Teramo",62,144,1567,24,48,1783,100,1530,56,261,1947
"067","Teramo",63,136,1628,40,50,1854,97,1528,33,273,1931
"067","Teramo",64,138,1540,27,52,1757,84,1434,43,273,1834
"067","Teramo",65,127,1557,28,49,1761,65,1355,41,341,1802
"067","Teramo",66,94,1217,24,57,1392,59,1173,28,292,1552
"067","Teramo",67,97,1278,25,47,1447,72,1068,23,323,1486
"067","Teramo",68,87,1299,14,70,1470,63,1082,27,396,1568
"067","Teramo",69,77,1228,21,52,1378,58,1028,11,415,1512
"067","Teramo",70,95,1268,19,63,1445,56,1013,18,453,1540
"067","Teramo",71,77,1368,17,82,1544,84,1104,23,542,1753
"067","Teramo",72,79,1341,16,99,1535,68,1036,10,566,1680
"067","Teramo",73,77,1287,21,106,1491,69,1000,19,624,1712
"067","Teramo",74,68,1226,12,131,1437,74,901,14,644,1633
"067","Teramo",75,68,1133,7,99,1307,50,842,8,637,1537
"067","Teramo",76,68,1103,8,131,1310,72,814,16,737,1639
"067","Teramo",77,56,955,19,134,1164,65,702,8,738,1513
"067","Teramo",78,63,1003,10,113,1189,70,640,14,809,1533
"067","Teramo",79,45,853,5,125,1028,90,516,8,762,1376
"067","Teramo",80,55,842,3,153,1053,83,508,5,764,1360
"067","Teramo",81,45,780,11,150,986,85,451,4,868,1408
"067","Teramo",82,42,693,5,135,875,75,354,7,800,1236
"067","Teramo",83,30,607,5,136,778,56,303,2,769,1130
"067","Teramo",84,34,508,4,129,675,60,265,5,806,1136
"067","Teramo",85,18,386,4,134,542,67,218,5,744,1034
"067","Teramo",86,20,338,2,132,492,62,177,5,698,942
"067","Teramo",87,8,280,0,117,405,53,132,3,652,840
"067","Teramo",88,12,214,0,112,338,55,88,3,579,725
"067","Teramo",89,10,182,3,111,306,42,77,1,562,682
"067","Teramo",90,8,135,1,92,236,34,56,3,449,542
"067","Teramo",91,6,109,0,78,193,27,31,4,380,442
"067","Teramo",92,3,53,0,42,98,20,16,0,258,294
"067","Teramo",93,4,30,0,28,62,8,8,0,133,149
"067","Teramo",94,0,23,0,18,41,6,7,0,115,128
"067","Teramo",95,3,21,0,22,46,7,5,1,133,146
"067","Teramo",96,0,18,1,21,40,11,5,0,111,127
"067","Teramo",97,1,9,0,11,21,3,5,1,67,76
"067","Teramo",98,0,8,0,16,24,6,2,0,55,63
"067","Teramo",99,0,5,0,7,12,3,1,0,29,33
"067","Teramo",100,0,2,0,16,18,7,2,0,57,66
"068","Pescara",0,1441,0,0,0,1441,1326,0,0,0,1326
"068","Pescara",1,1497,0,0,0,1497,1356,0,0,0,1356
"068","Pescara",2,1372,0,0,0,1372,1389,0,0,0,1389
"068","Pescara",3,1501,0,0,0,1501,1440,0,0,0,1440
"068","Pescara",4,1472,0,0,0,1472,1457,0,0,0,1457
"068","Pescara",5,1514,0,0,0,1514,1382,0,0,0,1382
"068","Pescara",6,1474,0,0,0,1474,1372,0,0,0,1372
"068","Pescara",7,1488,0,0,0,1488,1395,0,0,0,1395
"068","Pescara",8,1449,0,0,0,1449,1443,0,0,0,1443
"068","Pescara",9,1447,0,0,0,1447,1322,0,0,0,1322
"068","Pescara",10,1484,0,0,0,1484,1448,0,0,0,1448
"068","Pescara",11,1520,0,0,0,1520,1366,0,0,0,1366
"068","Pescara",12,1455,0,0,0,1455,1349,0,0,0,1349
"068","Pescara",13,1531,0,0,0,1531,1436,0,0,0,1436
"068","Pescara",14,1511,0,0,0,1511,1336,0,0,0,1336
"068","Pescara",15,1413,0,0,0,1413,1391,0,0,0,1391
"068","Pescara",16,1503,0,0,0,1503,1390,0,0,0,1390
"068","Pescara",17,1538,0,0,0,1538,1437,0,0,0,1437
"068","Pescara",18,1663,0,0,0,1663,1478,2,0,0,1480
"068","Pescara",19,1680,1,0,0,1681,1623,14,0,0,1637
"068","Pescara",20,1645,4,0,0,1649,1583,19,0,0,1602
"068","Pescara",21,1664,3,0,0,1667,1563,33,0,0,1596
"068","Pescara",22,1704,8,0,0,1712,1496,74,0,0,1570
"068","Pescara",23,1640,28,0,0,1668,1486,122,0,0,1608
"068","Pescara",24,1593,81,0,0,1674,1474,173,0,0,1647
"068","Pescara",25,1664,76,0,0,1740,1398,236,2,0,1636
"068","Pescara",26,1644,121,1,0,1766,1369,306,0,2,1677
"068","Pescara",27,1604,195,1,0,1800,1326,431,3,1,1761
"068","Pescara",28,1551,272,2,0,1825,1285,504,2,3,1794
"068","Pescara",29,1373,325,2,0,1700,1188,692,5,0,1885
"068","Pescara",30,1316,422,1,0,1739,1062,842,12,3,1919
"068","Pescara",31,1296,554,5,1,1856,932,937,13,4,1886
"068","Pescara",32,1273,668,7,3,1951,835,1123,15,7,1980
"068","Pescara",33,1206,851,9,0,2066,784,1278,31,6,2099
"068","Pescara",34,1156,935,13,0,2104,736,1355,24,10,2125
"068","Pescara",35,1079,1111,13,2,2205,705,1504,31,12,2252
"068","Pescara",36,983,1202,15,2,2202,668,1639,50,7,2364
"068","Pescara",37,1066,1408,21,0,2495,613,1637,46,11,2307
"068","Pescara",38,911,1478,30,3,2422,581,1853,59,15,2508
"068","Pescara",39,831,1587,37,1,2456,572,1943,75,21,2611
"068","Pescara",40,777,1645,44,2,2468,569,1941,106,10,2626
"068","Pescara",41,744,1732,54,7,2537,473,1954,75,17,2519
"068","Pescara",42,698,1815,59,2,2574,477,2040,113,23,2653
"068","Pescara",43,628,1789,71,5,2493,433,1975,125,30,2563
"068","Pescara",44,559,1756,78,10,2403,403,2069,101,40,2613
"068","Pescara",45,524,1932,52,13,2521,384,2123,115,44,2666
"068","Pescara",46,542,1973,80,14,2609,351,2072,134,36,2593
"068","Pescara",47,478,2063,85,16,2642,329,2129,117,51,2626
"068","Pescara",48,412,1982,81,12,2487,301,2002,126,57,2486
"068","Pescara",49,393,1804,84,5,2286,311,1947,126,72,2456
"068","Pescara",50,327,1795,87,12,2221,282,1885,111,71,2349
"068","Pescara",51,280,1775,82,15,2152,267,1826,110,89,2292
"068","Pescara",52,251,1702,76,17,2046,226,1780,120,99,2225
"068","Pescara",53,239,1679,68,17,2003,240,1717,106,91,2154
"068","Pescara",54,211,1699,73,29,2012,216,1795,109,106,2226
"068","Pescara",55,204,1636,75,13,1928,188,1673,76,137,2074
"068","Pescara",56,193,1619,63,23,1898,221,1716,100,122,2159
"068","Pescara",57,202,1561,66,22,1851,167,1609,81,162,2019
"068","Pescara",58,158,1515,56,18,1747,172,1548,98,141,1959
"068","Pescara",59,141,1478,48,28,1695,149,1506,100,172,1927
"068","Pescara",60,118,1508,62,30,1718,146,1678,81,182,2087
"068","Pescara",61,115,1584,44,29,1772,128,1623,78,217,2046
"068","Pescara",62,129,1601,55,34,1819,125,1577,74,216,1992
"068","Pescara",63,142,1633,47,58,1880,157,1625,64,304,2150
"068","Pescara",64,123,1637,56,54,1870,103,1582,77,311,2073
"068","Pescara",65,98,1629,39,56,1822,119,1529,57,302,2007
"068","Pescara",66,81,1243,34,45,1403,82,1116,52,271,1521
"068","Pescara",67,93,1326,37,72,1528,90,1207,47,347,1691
"068","Pescara",68,87,1277,27,46,1437,85,1161,36,380,1662
"068","Pescara",69,67,1245,26,67,1405,90,1114,52,403,1659
"068","Pescara",70,79,1201,25,69,1374,100,1054,35,432,1621
"068","Pescara",71,96,1370,27,92,1585,94,1216,38,508,1856
"068","Pescara",72,74,1383,35,107,1599,114,1190,43,631,1978
"068","Pescara",73,74,1254,25,115,1468,108,992,30,570,1700
"068","Pescara",74,63,1278,25,104,1470,107,917,18,635,1677
"068","Pescara",75,57,1166,18,124,1365,110,816,27,684,1637
"068","Pescara",76,48,1140,13,134,1335,101,809,21,725,1656
"068","Pescara",77,54,1053,10,131,1248,98,717,16,754,1585
"068","Pescara",78,64,984,13,138,1199,90,692,17,795,1594
"068","Pescara",79,52,857,9,140,1058,111,567,15,787,1480
"068","Pescara",80,34,822,9,145,1010,90,560,15,834,1499
"068","Pescara",81,37,804,12,120,973,123,513,19,908,1563
"068","Pescara",82,25,667,5,120,817,102,378,14,831,1325
"068","Pescara",83,33,610,6,138,787,70,348,11,828,1257
"068","Pescara",84,25,506,20,138,689,83,287,7,792,1169
"068","Pescara",85,18,465,0,142,625,89,212,9,767,1077
"068","Pescara",86,20,378,3,140,541,90,199,9,727,1025
"068","Pescara",87,15,303,1,137,456,58,132,11,653,854
"068","Pescara",88,9,240,3,108,360,62,111,11,580,764
"068","Pescara",89,5,172,0,111,288,55,82,0,574,711
"068","Pescara",90,10,162,2,108,282,42,55,2,446,545
"068","Pescara",91,8,121,0,64,193,48,53,0,436,537
"068","Pescara",92,1,71,0,40,112,29,28,3,239,299
"068","Pescara",93,2,36,0,23,61,21,8,1,142,172
"068","Pescara",94,2,23,0,29,54,11,6,0,145,162
"068","Pescara",95,3,24,0,24,51,14,10,0,123,147
"068","Pescara",96,3,20,0,24,47,21,13,1,119,154
"068","Pescara",97,1,8,0,23,32,12,5,0,84,101
"068","Pescara",98,0,7,0,5,12,7,2,0,58,67
"068","Pescara",99,1,5,0,15,21,5,7,0,35,47
"068","Pescara",100,0,4,0,13,17,8,3,0,62,73
"069","Chieti",0,1643,0,0,0,1643,1509,0,0,0,1509
"069","Chieti",1,1708,0,0,0,1708,1608,0,0,0,1608
"069","Chieti",2,1687,0,0,0,1687,1568,0,0,0,1568
"069","Chieti",3,1657,0,0,0,1657,1652,0,0,0,1652
"069","Chieti",4,1639,0,0,0,1639,1648,0,0,0,1648
"069","Chieti",5,1687,0,0,0,1687,1585,0,0,0,1585
"069","Chieti",6,1701,0,0,0,1701,1568,0,0,0,1568
"069","Chieti",7,1667,0,0,0,1667,1566,0,0,0,1566
"069","Chieti",8,1717,0,0,0,1717,1604,0,0,0,1604
"069","Chieti",9,1700,0,0,0,1700,1544,0,0,0,1544
"069","Chieti",10,1683,0,0,0,1683,1622,0,0,0,1622
"069","Chieti",11,1806,0,0,0,1806,1581,0,0,0,1581
"069","Chieti",12,1698,0,0,0,1698,1675,0,0,0,1675
"069","Chieti",13,1732,0,0,0,1732,1682,0,0,0,1682
"069","Chieti",14,1809,0,0,0,1809,1684,0,0,0,1684
"069","Chieti",15,1821,0,0,0,1821,1750,0,0,0,1750
"069","Chieti",16,1844,0,0,0,1844,1678,0,0,0,1678
"069","Chieti",17,1787,1,0,0,1788,1706,0,0,0,1706
"069","Chieti",18,1949,0,0,0,1949,1823,3,0,0,1826
"069","Chieti",19,1965,1,0,0,1966,1849,18,0,0,1867
"069","Chieti",20,2038,4,0,0,2042,1775,47,0,0,1822
"069","Chieti",21,2022,2,0,0,2024,1941,77,0,0,2018
"069","Chieti",22,2063,25,0,0,2088,1907,129,0,0,2036
"069","Chieti",23,2136,32,0,0,2168,1900,170,0,0,2070
"069","Chieti",24,2015,48,0,0,2063,1756,250,0,0,2006
"069","Chieti",25,2105,116,0,0,2221,1713,302,5,1,2021
"069","Chieti",26,2133,164,1,0,2298,1827,418,1,1,2247
"069","Chieti",27,2129,226,3,0,2358,1659,550,4,2,2215
"069","Chieti",28,2009,327,6,0,2342,1560,666,8,2,2236
"069","Chieti",29,2016,470,5,0,2491,1453,890,16,0,2359
"069","Chieti",30,1822,569,4,0,2395,1255,964,15,3,2237
"069","Chieti",31,1769,686,8,0,2463,1171,1203,15,10,2399
"069","Chieti",32,1741,900,6,1,2648,1041,1368,23,7,2439
"069","Chieti",33,1573,1040,9,1,2623,988,1530,34,8,2560
"069","Chieti",34,1470,1228,9,0,2707,924,1616,33,9,2582
"069","Chieti",35,1364,1374,18,0,2756,884,1825,38,7,2754
"069","Chieti",36,1249,1501,22,4,2776,761,1982,62,13,2818
"069","Chieti",37,1222,1661,30,1,2914,688,2050,72,23,2833
"069","Chieti",38,1063,1794,51,5,2913,599,2121,70,18,2808
"069","Chieti",39,925,1854,35,9,2823,606,2145,92,18,2861
"069","Chieti",40,895,1955,40,6,2896,550,2368,99,23,3040
"069","Chieti",41,819,1944,49,3,2815,479,2363,98,32,2972
"069","Chieti",42,776,2100,69,2,2947,474,2399,100,28,3001
"069","Chieti",43,681,2230,62,2,2975,413,2458,120,46,3037
"069","Chieti",44,578,2314,74,7,2973,414,2557,128,49,3148
"069","Chieti",45,569,2351,88,9,3017,391,2428,121,65,3005
"069","Chieti",46,517,2418,77,14,3026,348,2603,125,59,3135
"069","Chieti",47,525,2355,96,12,2988,339,2591,96,55,3081
"069","Chieti",48,435,2188,84,20,2727,298,2364,114,67,2843
"069","Chieti",49,409,2144,72,18,2643,267,2327,118,97,2809
"069","Chieti",50,386,2122,83,17,2608,307,2392,107,97,2903
"069","Chieti",51,358,2163,72,14,2607,239,2346,126,104,2815
"069","Chieti",52,329,2108,80,16,2533,229,2310,102,113,2754
"069","Chieti",53,305,2092,87,30,2514,234,2240,108,114,2696
"069","Chieti",54,297,2055,73,24,2449,238,2216,100,142,2696
"069","Chieti",55,245,2147,84,20,2496,190,2179,81,158,2608
"069","Chieti",56,259,2048,66,35,2408,191,2266,93,176,2726
"069","Chieti",57,248,2068,58,37,2411,163,2132,77,214,2586
"069","Chieti",58,204,2015,61,32,2312,171,2016,84,215,2486
"069","Chieti",59,219,2052,56,39,2366,136,2073,66,262,2537
"069","Chieti",60,178,2076,51,48,2353,144,2070,64,272,2550
"069","Chieti",61,200,2254,65,57,2576,147,2139,66,303,2655
"069","Chieti",62,192,2378,70,48,2688,143,2141,48,365,2697
"069","Chieti",63,184,2208,49,53,2494,134,2217,59,366,2776
"069","Chieti",64,150,2191,69,50,2460,113,1926,46,416,2501
"069","Chieti",65,155,2189,47,73,2464,110,1938,49,455,2552
"069","Chieti",66,109,1553,32,53,1747,94,1409,41,364,1908
"069","Chieti",67,108,1775,27,80,1990,100,1456,36,466,2058
"069","Chieti",68,86,1556,33,71,1746,93,1341,31,469,1934
"069","Chieti",69,103,1578,30,79,1790,88,1259,33,503,1883
"069","Chieti",70,106,1636,17,99,1858,84,1260,28,535,1907
"069","Chieti",71,119,1780,24,120,2043,127,1380,27,655,2189
"069","Chieti",72,108,1795,36,137,2076,111,1410,24,777,2322
"069","Chieti",73,96,1640,26,143,1905,106,1185,24,737,2052
"069","Chieti",74,102,1632,21,140,1895,103,1170,29,863,2165
"069","Chieti",75,93,1432,21,139,1685,126,1081,17,862,2086
"069","Chieti",76,89,1489,19,136,1733,127,1056,19,914,2116
"069","Chieti",77,79,1366,9,170,1624,96,978,16,979,2069
"069","Chieti",78,63,1354,7,174,1598,128,850,22,1115,2115
"069","Chieti",79,70,1214,15,198,1497,95,715,16,989,1815
"069","Chieti",80,55,1112,11,189,1367,140,694,19,1095,1948
"069","Chieti",81,59,1168,7,237,1471,121,651,20,1215,2007
"069","Chieti",82,38,880,6,208,1132,113,506,14,1089,1722
"069","Chieti",83,33,813,6,201,1053,110,428,14,1064,1616
"069","Chieti",84,38,705,1,237,981,98,391,13,1125,1627
"069","Chieti",85,21,612,4,201,838,99,294,3,1034,1430
"069","Chieti",86,27,491,2,223,743,102,251,9,896,1258
"069","Chieti",87,20,366,2,203,591,102,187,5,844,1138
"069","Chieti",88,10,333,0,172,515,76,130,9,844,1059
"069","Chieti",89,10,246,3,181,440,85,100,8,758,951
"069","Chieti",90,5,238,1,158,402,69,74,4,736,883
"069","Chieti",91,12,189,0,125,326,57,44,4,589,694
"069","Chieti",92,5,75,0,77,157,44,28,2,299,373
"069","Chieti",93,3,30,0,40,73,12,19,0,184,215
"069","Chieti",94,1,40,0,37,78,18,7,1,174,200
"069","Chieti",95,1,33,0,45,79,13,12,1,182,208
"069","Chieti",96,1,26,0,40,67,16,7,0,164,187
"069","Chieti",97,2,19,0,31,52,6,2,0,122,130
"069","Chieti",98,0,8,0,24,32,2,3,0,80,85
"069","Chieti",99,2,2,0,16,20,4,0,0,68,72
"069","Chieti",100,1,6,0,21,28,10,1,0,82,93
"070","Campobasso",0,849,0,0,0,849,854,0,0,0,854
"070","Campobasso",1,944,0,0,0,944,857,0,0,0,857
"070","Campobasso",2,861,0,0,0,861,804,0,0,0,804
"070","Campobasso",3,949,0,0,0,949,868,0,0,0,868
"070","Campobasso",4,937,0,0,0,937,878,0,0,0,878
"070","Campobasso",5,943,0,0,0,943,895,0,0,0,895
"070","Campobasso",6,989,0,0,0,989,863,0,0,0,863
"070","Campobasso",7,1018,0,0,0,1018,896,0,0,0,896
"070","Campobasso",8,1019,0,0,0,1019,947,0,0,0,947
"070","Campobasso",9,994,0,0,0,994,963,0,0,0,963
"070","Campobasso",10,1013,0,0,0,1013,968,0,0,0,968
"070","Campobasso",11,1040,0,0,0,1040,1029,0,0,0,1029
"070","Campobasso",12,1122,0,0,0,1122,1055,0,0,0,1055
"070","Campobasso",13,1109,0,0,0,1109,1013,0,0,0,1013
"070","Campobasso",14,1105,0,0,0,1105,1030,0,0,0,1030
"070","Campobasso",15,1075,0,0,0,1075,1054,0,0,0,1054
"070","Campobasso",16,1121,0,0,0,1121,1118,0,0,0,1118
"070","Campobasso",17,1185,0,0,0,1185,1103,0,0,0,1103
"070","Campobasso",18,1198,0,0,0,1198,1137,4,0,0,1141
"070","Campobasso",19,1274,1,0,0,1275,1211,5,0,1,1217
"070","Campobasso",20,1287,3,0,0,1290,1158,22,0,0,1180
"070","Campobasso",21,1263,3,0,0,1266,1163,35,0,0,1198
"070","Campobasso",22,1250,12,0,0,1262,1157,63,0,1,1221
"070","Campobasso",23,1282,28,0,0,1310,1189,97,0,1,1287
"070","Campobasso",24,1315,42,0,0,1357,1077,116,3,1,1197
"070","Campobasso",25,1218,49,0,0,1267,1035,158,1,0,1194
"070","Campobasso",26,1271,79,0,0,1350,1052,247,1,0,1300
"070","Campobasso",27,1215,114,0,0,1329,1084,303,0,0,1387
"070","Campobasso",28,1227,164,0,0,1391,964,368,2,1,1335
"070","Campobasso",29,1161,226,0,0,1387,879,485,3,1,1368
"070","Campobasso",30,1136,289,3,0,1428,768,583,9,1,1361
"070","Campobasso",31,1035,348,0,0,1383,684,665,17,2,1368
"070","Campobasso",32,977,475,5,0,1457,617,805,12,5,1439
"070","Campobasso",33,928,556,4,0,1488,548,890,10,6,1454
"070","Campobasso",34,814,670,2,0,1486,528,951,12,3,1494
"070","Campobasso",35,806,748,10,0,1564,451,927,26,8,1412
"070","Campobasso",36,761,882,4,0,1647,449,1134,23,7,1613
"070","Campobasso",37,678,989,11,1,1679,379,1224,27,5,1635
"070","Campobasso",38,625,945,16,1,1587,324,1212,38,8,1582
"070","Campobasso",39,564,1077,15,2,1658,342,1265,32,9,1648
"070","Campobasso",40,513,1072,21,3,1609,262,1272,39,16,1589
"070","Campobasso",41,428,1198,27,2,1655,266,1306,47,19,1638
"070","Campobasso",42,440,1269,29,3,1741,266,1387,55,23,1731
"070","Campobasso",43,415,1233,28,4,1680,270,1367,52,20,1709
"070","Campobasso",44,380,1292,30,7,1709,221,1492,44,27,1784
"070","Campobasso",45,350,1331,31,4,1716,233,1541,54,28,1856
"070","Campobasso",46,305,1421,35,6,1767,212,1463,39,45,1759
"070","Campobasso",47,331,1442,30,8,1811,198,1505,43,47,1793
"070","Campobasso",48,294,1378,33,8,1713,159,1407,41,46,1653
"070","Campobasso",49,236,1382,36,9,1663,153,1445,44,55,1697
"070","Campobasso",50,239,1408,32,25,1704,150,1388,66,58,1662
"070","Campobasso",51,231,1369,39,8,1647,160,1391,43,74,1668
"070","Campobasso",52,189,1279,35,16,1519,154,1394,43,69,1660
"070","Campobasso",53,184,1210,33,12,1439,144,1365,57,84,1650
"070","Campobasso",54,172,1292,34,18,1516,126,1276,40,106,1548
"070","Campobasso",55,177,1310,35,18,1540,109,1278,32,108,1527
"070","Campobasso",56,143,1300,29,33,1505,116,1227,39,122,1504
"070","Campobasso",57,170,1256,35,22,1483,110,1294,44,139,1587
"070","Campobasso",58,122,1219,29,15,1385,100,1117,40,111,1368
"070","Campobasso",59,124,1228,25,24,1401,100,1223,27,142,1492
"070","Campobasso",60,88,1192,22,30,1332,100,1112,24,146,1382
"070","Campobasso",61,98,1294,35,27,1454,100,1170,18,177,1465
"070","Campobasso",62,120,1334,23,40,1517,95,1191,20,235,1541
"070","Campobasso",63,112,1324,24,36,1496,101,1171,25,212,1509
"070","Campobasso",64,105,1207,22,35,1369,89,1087,19,254,1449
"070","Campobasso",65,102,1178,22,41,1343,93,985,25,239,1342
"070","Campobasso",66,62,907,19,40,1028,63,788,10,242,1103
"070","Campobasso",67,44,911,14,47,1016,58,757,8,249,1072
"070","Campobasso",68,56,870,9,38,973,63,710,16,245,1034
"070","Campobasso",69,55,808,12,43,918,55,661,15,263,994
"070","Campobasso",70,53,884,8,76,1021,48,738,12,338,1136
"070","Campobasso",71,71,996,11,69,1147,90,803,14,408,1315
"070","Campobasso",72,65,1027,10,81,1183,98,869,17,467,1451
"070","Campobasso",73,50,919,6,80,1055,67,689,6,430,1192
"070","Campobasso",74,43,861,6,107,1017,74,708,10,483,1275
"070","Campobasso",75,60,822,4,109,995,96,678,14,483,1271
"070","Campobasso",76,51,819,10,100,980,71,653,9,593,1326
"070","Campobasso",77,56,838,3,115,1012,85,595,7,573,1260
"070","Campobasso",78,39,783,5,110,937,101,518,9,618,1246
"070","Campobasso",79,39,685,1,128,853,79,457,6,594,1136
"070","Campobasso",80,34,625,5,136,800,90,427,6,571,1094
"070","Campobasso",81,26,602,7,142,777,105,416,4,681,1206
"070","Campobasso",82,29,511,0,126,666,63,320,2,617,1002
"070","Campobasso",83,14,464,1,119,598,78,296,2,605,981
"070","Campobasso",84,14,401,1,137,553,84,228,6,672,990
"070","Campobasso",85,20,310,3,138,471,80,196,6,594,876
"070","Campobasso",86,6,270,0,132,408,46,159,7,494,706
"070","Campobasso",87,10,218,1,107,336,52,110,3,498,663
"070","Campobasso",88,12,183,1,103,299,63,94,3,434,594
"070","Campobasso",89,7,147,1,104,259,38,84,0,440,562
"070","Campobasso",90,4,128,0,94,226,38,70,0,394,502
"070","Campobasso",91,3,90,0,79,172,31,42,2,327,402
"070","Campobasso",92,3,42,0,34,79,13,13,1,176,203
"070","Campobasso",93,0,31,0,16,47,9,9,0,107,125
"070","Campobasso",94,2,27,0,14,43,8,6,2,92,108
"070","Campobasso",95,1,23,0,26,50,6,5,0,103,114
"070","Campobasso",96,4,11,1,17,33,6,5,1,112,124
"070","Campobasso",97,0,6,0,21,27,5,2,1,63,71
"070","Campobasso",98,1,5,0,10,16,4,6,0,49,59
"070","Campobasso",99,1,1,0,4,6,2,2,0,49,53
"070","Campobasso",100,0,4,0,14,18,1,4,0,51,56
"071","Foggia",0,2803,0,0,0,2803,2736,0,0,0,2736
"071","Foggia",1,2997,0,0,0,2997,2802,0,0,0,2802
"071","Foggia",2,3067,0,0,0,3067,2942,0,0,0,2942
"071","Foggia",3,3165,0,0,0,3165,2889,0,0,0,2889
"071","Foggia",4,3099,0,0,0,3099,2973,0,0,0,2973
"071","Foggia",5,3121,0,0,0,3121,2962,0,0,0,2962
"071","Foggia",6,3219,0,0,0,3219,3106,0,0,0,3106
"071","Foggia",7,3390,0,0,0,3390,3141,0,0,0,3141
"071","Foggia",8,3342,0,0,0,3342,3258,0,0,0,3258
"071","Foggia",9,3407,0,0,0,3407,3278,0,0,0,3278
"071","Foggia",10,3507,0,0,0,3507,3291,0,0,0,3291
"071","Foggia",11,3547,0,0,0,3547,3388,0,0,0,3388
"071","Foggia",12,3657,0,0,0,3657,3349,0,0,0,3349
"071","Foggia",13,3687,0,0,0,3687,3469,0,0,0,3469
"071","Foggia",14,3633,0,0,0,3633,3454,0,0,0,3454
"071","Foggia",15,3542,0,0,0,3542,3462,0,0,0,3462
"071","Foggia",16,3634,0,0,0,3634,3360,0,0,0,3360
"071","Foggia",17,3789,0,0,0,3789,3450,2,0,0,3452
"071","Foggia",18,3923,1,0,0,3924,3530,19,0,0,3549
"071","Foggia",19,4068,7,0,0,4075,3830,62,0,0,3892
"071","Foggia",20,4021,12,0,0,4033,3622,112,0,0,3734
"071","Foggia",21,4042,47,0,0,4089,3698,215,0,0,3913
"071","Foggia",22,3959,75,0,1,4035,3636,327,1,0,3964
"071","Foggia",23,3920,121,0,0,4041,3439,439,0,0,3878
"071","Foggia",24,3874,212,0,0,4086,3258,573,2,0,3833
"071","Foggia",25,3678,285,1,0,3964,3022,755,3,2,3782
"071","Foggia",26,3425,382,0,0,3807,2775,985,4,1,3765
"071","Foggia",27,3257,556,1,0,3814,2615,1299,12,1,3927
"071","Foggia",28,3212,757,1,0,3970,2338,1542,12,7,3899
"071","Foggia",29,3047,985,4,1,4037,2177,1795,7,10,3989
"071","Foggia",30,2727,1285,5,1,4018,1867,2103,14,6,3990
"071","Foggia",31,2556,1508,4,2,4070,1564,2343,23,13,3943
"071","Foggia",32,2300,1788,10,2,4100,1473,2564,20,10,4067
"071","Foggia",33,2156,1954,11,3,4124,1322,2844,46,15,4227
"071","Foggia",34,1958,2389,15,3,4365,1244,3012,36,16,4308
"071","Foggia",35,1873,2510,18,7,4408,1115,3169,45,21,4350
"071","Foggia",36,1670,2859,25,7,4561,1035,3325,50,19,4429
"071","Foggia",37,1526,2989,25,9,4549,879,3652,69,33,4633
"071","Foggia",38,1385,3031,28,5,4449,852,3550,82,40,4524
"071","Foggia",39,1198,3164,40,7,4409,793,3592,79,36,4500
"071","Foggia",40,1143,3365,51,8,4567,730,3811,75,44,4660
"071","Foggia",41,1028,3388,61,7,4484,696,3747,102,59,4604
"071","Foggia",42,1018,3683,58,6,4765,702,3877,95,64,4738
"071","Foggia",43,888,3642,51,11,4592,638,3935,84,80,4737
"071","Foggia",44,814,3845,64,12,4735,617,4074,108,91,4890
"071","Foggia",45,786,3902,64,22,4774,616,3974,101,110,4801
"071","Foggia",46,689,3956,56,21,4722,563,4071,111,95,4840
"071","Foggia",47,668,4038,72,25,4803,603,4208,104,134,5049
"071","Foggia",48,566,3722,82,30,4400,533,3938,104,142,4717
"071","Foggia",49,559,3672,65,21,4317,482,3828,128,144,4582
"071","Foggia",50,485,3629,70,20,4204,445,3614,94,138,4291
"071","Foggia",51,457,3616,76,39,4188,461,3626,110,168,4365
"071","Foggia",52,434,3499,67,30,4030,452,3529,110,159,4250
"071","Foggia",53,388,3397,64,38,3887,375,3493,111,215,4194
"071","Foggia",54,349,3301,63,48,3761,384,3340,103,230,4057
"071","Foggia",55,329,3315,64,47,3755,369,3360,110,232,4071
"071","Foggia",56,296,3365,63,55,3779,360,3228,113,277,3978
"071","Foggia",57,316,3360,53,61,3790,316,3214,87,289,3906
"071","Foggia",58,251,3115,69,73,3508,295,3006,88,315,3704
"071","Foggia",59,248,3068,52,62,3430,309,2881,77,318,3585
"071","Foggia",60,185,3088,60,57,3390,279,2867,89,354,3589
"071","Foggia",61,239,3108,59,80,3486,312,2937,66,431,3746
"071","Foggia",62,192,3355,55,92,3694,298,3035,66,457,3856
"071","Foggia",63,213,3442,53,111,3819,307,3232,74,572,4185
"071","Foggia",64,205,3202,45,105,3557,322,2799,52,538,3711
"071","Foggia",65,170,3171,48,115,3504,274,2858,63,648,3843
"071","Foggia",66,144,2635,39,121,2939,236,2374,62,575,3247
"071","Foggia",67,119,2419,32,114,2684,209,2117,42,596,2964
"071","Foggia",68,104,2253,29,129,2515,232,1990,41,614,2877
"071","Foggia",69,136,2415,33,163,2747,223,1920,33,697,2873
"071","Foggia",70,105,2282,20,119,2526,213,1890,40,741,2884
"071","Foggia",71,136,2442,22,206,2806,252,2084,34,904,3274
"071","Foggia",72,120,2431,27,200,2778,282,1954,43,1000,3279
"071","Foggia",73,119,2277,19,200,2615,276,1795,20,1059,3150
"071","Foggia",74,87,2064,26,199,2376,245,1630,28,1091,2994
"071","Foggia",75,103,1909,21,227,2260,242,1445,38,1208,2933
"071","Foggia",76,78,1931,18,262,2289,198,1423,38,1200,2859
"071","Foggia",77,80,1753,12,270,2115,230,1310,22,1302,2864
"071","Foggia",78,70,1668,16,264,2018,201,1192,23,1321,2737
"071","Foggia",79,68,1472,9,296,1845,239,992,19,1289,2539
"071","Foggia",80,48,1281,13,287,1629,200,846,19,1328,2393
"071","Foggia",81,53,1309,7,305,1674,224,821,13,1473,2531
"071","Foggia",82,49,1074,7,314,1444,177,622,13,1326,2138
"071","Foggia",83,47,948,7,323,1325,203,578,14,1325,2120
"071","Foggia",84,36,913,4,305,1258,179,558,11,1350,2098
"071","Foggia",85,28,718,7,297,1050,158,372,12,1223,1765
"071","Foggia",86,25,679,3,292,999,192,284,9,1095,1580
"071","Foggia",87,35,496,1,290,822,118,262,2,1007,1389
"071","Foggia",88,29,384,2,291,706,129,191,4,1018,1342
"071","Foggia",89,15,323,2,223,563,95,112,7,833,1047
"071","Foggia",90,18,222,0,171,411,79,67,8,807,961
"071","Foggia",91,11,161,1,174,347,75,56,10,676,817
"071","Foggia",92,10,91,1,94,196,28,23,3,336,390
"071","Foggia",93,5,36,1,53,95,26,7,2,195,230
"071","Foggia",94,4,35,0,64,103,28,7,0,188,223
"071","Foggia",95,2,36,0,52,90,24,8,0,154,186
"071","Foggia",96,2,23,0,61,86,24,5,1,158,188
"071","Foggia",97,1,25,0,44,70,13,5,1,142,161
"071","Foggia",98,1,15,0,21,37,9,5,2,97,113
"071","Foggia",99,3,7,0,19,29,7,3,0,65,75
"071","Foggia",100,0,6,0,36,42,7,2,0,106,115
"072","Bari",0,5756,0,0,0,5756,5429,0,0,0,5429
"072","Bari",1,5660,0,0,0,5660,5595,0,0,0,5595
"072","Bari",2,5772,0,0,0,5772,5455,0,0,0,5455
"072","Bari",3,5838,0,0,0,5838,5568,0,0,0,5568
"072","Bari",4,5882,0,0,0,5882,5630,0,0,0,5630
"072","Bari",5,6000,0,0,0,6000,5666,0,0,0,5666
"072","Bari",6,6201,0,0,0,6201,5643,0,0,0,5643
"072","Bari",7,6211,0,0,0,6211,6092,0,0,0,6092
"072","Bari",8,6286,0,0,0,6286,6078,0,0,0,6078
"072","Bari",9,6257,0,0,0,6257,6010,0,0,0,6010
"072","Bari",10,6596,0,0,0,6596,6166,0,0,0,6166
"072","Bari",11,6752,0,0,0,6752,6278,0,0,0,6278
"072","Bari",12,6639,0,0,0,6639,6288,0,0,0,6288
"072","Bari",13,6507,0,0,0,6507,6356,0,0,0,6356
"072","Bari",14,6741,0,0,0,6741,6251,0,0,0,6251
"072","Bari",15,6954,0,0,0,6954,6543,0,0,0,6543
"072","Bari",16,6871,0,0,0,6871,6453,0,0,0,6453
"072","Bari",17,6896,1,0,0,6897,6576,6,0,0,6582
"072","Bari",18,7244,0,0,0,7244,6759,23,0,0,6782
"072","Bari",19,7475,14,0,0,7489,7051,121,0,0,7172
"072","Bari",20,7740,26,0,0,7766,6924,194,1,0,7119
"072","Bari",21,7587,64,0,0,7651,6821,292,0,0,7113
"072","Bari",22,7449,107,0,0,7556,6776,455,1,1,7233
"072","Bari",23,7752,217,0,0,7969,6860,657,3,1,7521
"072","Bari",24,7385,307,0,1,7693,6487,943,3,0,7433
"072","Bari",25,7131,487,0,0,7618,6056,1298,7,3,7364
"072","Bari",26,6864,628,1,0,7493,5536,1717,5,3,7261
"072","Bari",27,6829,941,4,0,7774,5219,2399,5,5,7628
"072","Bari",28,6525,1305,4,2,7836,4841,2762,14,4,7621
"072","Bari",29,6103,1774,5,0,7882,4540,3520,23,10,8093
"072","Bari",30,5573,2305,5,3,7886,3826,4043,26,11,7906
"072","Bari",31,5100,2807,10,2,7919,3476,4604,39,18,8137
"072","Bari",32,4707,3484,17,1,8209,3029,5168,47,20,8264
"072","Bari",33,4546,4154,24,4,8728,2741,5693,68,20,8522
"072","Bari",34,4135,4673,31,2,8841,2600,6142,90,24,8856
"072","Bari",35,3738,5302,37,6,9083,2476,6756,109,24,9365
"072","Bari",36,3493,5909,47,7,9456,2157,7338,140,52,9687
"072","Bari",37,3238,6370,53,4,9665,2030,7773,158,53,10014
"072","Bari",38,2778,6548,85,4,9415,1821,7607,181,61,9670
"072","Bari",39,2547,6628,96,9,9280,1625,7539,197,60,9421
"072","Bari",40,2320,6983,121,9,9433,1490,7845,218,75,9628
"072","Bari",41,2104,7278,141,13,9536,1355,7839,226,84,9504
"072","Bari",42,1909,7339,125,21,9394,1378,8133,276,121,9908
"072","Bari",43,1716,7628,169,26,9539,1342,8235,248,123,9948
"072","Bari",44,1600,7977,162,22,9761,1257,8386,276,158,10077
"072","Bari",45,1435,8221,189,36,9881,1180,8684,271,145,10280
"072","Bari",46,1369,8231,207,39,9846,1216,8771,293,196,10476
"072","Bari",47,1273,8438,223,42,9976,1145,8695,333,229,10402
"072","Bari",48,1062,7835,195,55,9147,1028,8170,301,233,9732
"072","Bari",49,976,7726,190,61,8953,1001,7953,302,266,9522
"072","Bari",50,871,7892,180,45,8988,951,7901,325,263,9440
"072","Bari",51,826,7580,219,59,8684,897,7522,295,333,9047
"072","Bari",52,746,7374,205,63,8388,815,7669,318,338,9140
"072","Bari",53,630,6996,181,87,7894,779,7254,286,324,8643
"072","Bari",54,658,7259,189,82,8188,777,7174,308,391,8650
"072","Bari",55,570,6979,185,80,7814,781,7080,251,460,8572
"072","Bari",56,521,6803,184,84,7592,692,6732,251,479,8154
"072","Bari",57,508,6865,156,113,7642,688,6793,239,540,8260
"072","Bari",58,431,6547,171,97,7246,614,6311,237,575,7737
"072","Bari",59,435,6426,152,120,7133,602,6221,211,539,7573
"072","Bari",60,413,6428,145,168,7154,629,5964,205,639,7437
"072","Bari",61,355,6843,149,157,7504,614,6396,224,759,7993
"072","Bari",62,372,6676,151,172,7371,682,6128,222,855,7887
"072","Bari",63,340,7104,136,208,7788,674,6511,220,1028,8433
"072","Bari",64,327,6630,130,218,7305,630,6014,167,1081,7892
"072","Bari",65,307,6578,134,259,7278,564,5899,180,1200,7843
"072","Bari",66,261,5670,92,240,6263,569,4887,141,1176,6773
"072","Bari",67,252,4902,82,224,5460,504,4264,110,1113,5991
"072","Bari",68,219,4825,72,238,5354,474,4169,117,1162,5922
"072","Bari",69,216,4921,80,276,5493,506,4206,128,1359,6199
"072","Bari",70,196,4688,66,287,5237,482,3928,89,1450,5949
"072","Bari",71,233,5090,72,335,5730,517,4005,110,1711,6343
"072","Bari",72,212,4622,52,350,5236,469,3732,103,1737,6041
"072","Bari",73,172,4440,66,382,5060,439,3494,75,1932,5940
"072","Bari",74,186,4142,45,413,4786,461,3228,71,2050,5810
"072","Bari",75,157,3700,41,446,4344,447,2780,72,2032,5331
"072","Bari",76,146,3681,33,406,4266,449,2702,70,2218,5439
"072","Bari",77,162,3356,32,499,4049,476,2444,66,2336,5322
"072","Bari",78,147,3285,24,547,4003,453,2148,68,2479,5148
"072","Bari",79,113,2918,28,526,3585,431,1898,54,2453,4836
"072","Bari",80,149,2728,25,584,3486,433,1684,52,2623,4792
"072","Bari",81,127,2534,19,663,3343,389,1540,42,2690,4661
"072","Bari",82,113,2076,13,581,2783,415,1178,23,2410,4026
"072","Bari",83,92,1881,12,557,2542,379,982,30,2496,3887
"072","Bari",84,91,1589,7,533,2220,355,863,31,2423,3672
"072","Bari",85,67,1311,12,516,1906,356,635,40,2217,3248
"072","Bari",86,71,1106,11,478,1666,306,482,27,1999,2814
"072","Bari",87,44,898,7,461,1410,252,338,19,1845,2454
"072","Bari",88,33,721,3,439,1196,244,322,16,1754,2336
"072","Bari",89,36,600,7,383,1026,194,198,17,1525,1934
"072","Bari",90,20,391,1,327,739,174,141,17,1345,1677
"072","Bari",91,32,367,2,290,691,164,110,8,1214,1496
"072","Bari",92,13,170,1,149,333,83,53,5,648,789
"072","Bari",93,9,87,0,131,227,61,27,0,411,499
"072","Bari",94,9,85,1,92,187,56,24,2,398,480
"072","Bari",95,4,66,0,87,157,55,19,1,338,413
"072","Bari",96,6,49,0,93,148,52,13,3,322,390
"072","Bari",97,2,28,2,59,91,27,14,0,206,247
"072","Bari",98,1,23,0,60,84,27,11,1,179,218
"072","Bari",99,4,15,0,33,52,20,7,0,102,129
"072","Bari",100,1,12,0,28,41,26,9,1,155,191
"073","Taranto",0,2757,0,0,0,2757,2627,0,0,0,2627
"073","Taranto",1,2798,0,0,0,2798,2613,0,0,0,2613
"073","Taranto",2,2767,0,0,0,2767,2580,0,0,0,2580
"073","Taranto",3,2673,0,0,0,2673,2561,0,0,0,2561
"073","Taranto",4,2822,0,0,0,2822,2715,0,0,0,2715
"073","Taranto",5,2759,0,0,0,2759,2727,0,0,0,2727
"073","Taranto",6,2823,0,0,0,2823,2751,0,0,0,2751
"073","Taranto",7,2874,0,0,0,2874,2889,0,0,0,2889
"073","Taranto",8,2903,0,0,0,2903,2871,0,0,0,2871
"073","Taranto",9,2913,0,0,0,2913,2813,0,0,0,2813
"073","Taranto",10,3090,0,0,0,3090,2820,0,0,0,2820
"073","Taranto",11,2972,0,0,0,2972,2866,0,0,0,2866
"073","Taranto",12,2991,0,0,0,2991,2754,0,0,0,2754
"073","Taranto",13,2920,0,0,0,2920,2844,0,0,0,2844
"073","Taranto",14,3021,0,0,0,3021,3006,0,0,0,3006
"073","Taranto",15,3116,0,0,0,3116,2899,0,0,0,2899
"073","Taranto",16,3206,0,0,0,3206,3077,0,0,0,3077
"073","Taranto",17,3327,0,0,0,3327,3045,0,0,0,3045
"073","Taranto",18,3374,2,0,0,3376,3252,4,0,0,3256
"073","Taranto",19,3594,2,0,0,3596,3265,21,0,0,3286
"073","Taranto",20,3482,6,0,0,3488,3269,57,0,0,3326
"073","Taranto",21,3470,16,0,0,3486,3389,85,0,0,3474
"073","Taranto",22,3539,23,0,0,3562,3291,170,0,0,3461
"073","Taranto",23,3593,50,0,0,3643,3101,264,0,0,3365
"073","Taranto",24,3419,103,0,0,3522,3080,415,1,0,3496
"073","Taranto",25,3496,183,1,0,3680,2969,583,1,0,3553
"073","Taranto",26,3376,253,0,0,3629,2694,809,4,1,3508
"073","Taranto",27,3328,415,1,1,3745,2517,1116,7,1,3641
"073","Taranto",28,3219,585,0,1,3805,2224,1358,4,2,3588
"073","Taranto",29,2901,789,1,1,3692,1970,1662,11,3,3646
"073","Taranto",30,2656,1096,6,1,3759,1829,1943,8,7,3787
"073","Taranto",31,2516,1425,3,0,3944,1623,2250,19,6,3898
"073","Taranto",32,2321,1734,6,3,4064,1499,2562,23,8,4092
"073","Taranto",33,2170,2063,6,2,4241,1359,2775,32,7,4173
"073","Taranto",34,2109,2403,12,3,4527,1274,3019,49,18,4360
"073","Taranto",35,1950,2579,18,2,4549,1184,3227,64,19,4494
"073","Taranto",36,1827,2803,24,6,4660,1081,3498,55,17,4651
"073","Taranto",37,1490,2997,30,3,4520,923,3476,95,28,4522
"073","Taranto",38,1290,3093,34,2,4419,872,3479,90,32,4473
"073","Taranto",39,1248,3317,43,8,4616,807,3523,93,35,4458
"073","Taranto",40,1149,3114,49,7,4319,678,3630,101,35,4444
"073","Taranto",41,1061,3058,63,15,4197,646,3485,98,40,4269
"073","Taranto",42,900,3285,66,12,4263,635,3751,110,57,4553
"073","Taranto",43,794,3277,71,9,4151,581,3805,115,69,4570
"073","Taranto",44,718,3398,80,14,4210,578,3908,138,76,4700
"073","Taranto",45,723,3500,75,15,4313,518,3886,133,82,4619
"073","Taranto",46,474,3665,95,20,4254,499,3802,130,121,4552
"073","Taranto",47,489,3543,81,25,4138,495,3824,133,85,4537
"073","Taranto",48,502,3385,76,19,3982,409,3627,128,105,4269
"073","Taranto",49,423,3397,71,20,3911,417,3619,143,118,4297
"073","Taranto",50,363,3484,83,25,3955,339,3609,118,165,4231
"073","Taranto",51,324,3469,92,22,3907,334,3491,105,214,4144
"073","Taranto",52,320,3335,94,36,3785,320,3379,124,175,3998
"073","Taranto",53,270,3251,74,47,3642,304,3351,111,196,3962
"073","Taranto",54,269,3276,66,37,3648,305,3403,109,225,4042
"073","Taranto",55,219,3224,65,42,3550,259,3221,132,238,3850
"073","Taranto",56,212,3253,97,49,3611,256,3317,120,277,3970
"073","Taranto",57,171,3122,69,48,3410,226,3113,95,211,3645
"073","Taranto",58,178,3150,59,50,3437,205,3018,83,284,3590
"073","Taranto",59,130,3015,61,73,3279,231,3050,95,334,3710
"073","Taranto",60,139,3175,57,73,3444,243,3018,99,384,3744
"073","Taranto",61,167,3369,59,72,3667,207,3072,108,399,3786
"073","Taranto",62,131,3500,56,93,3780,261,3041,85,517,3904
"073","Taranto",63,143,3494,60,116,3813,279,3071,82,556,3988
"073","Taranto",64,136,3311,62,108,3617,229,2971,94,594,3888
"073","Taranto",65,118,3139,54,116,3427,253,2852,74,627,3806
"073","Taranto",66,98,2701,39,101,2939,185,2345,54,588,3172
"073","Taranto",67,94,2460,25,110,2689,166,2260,50,605,3081
"073","Taranto",68,102,2428,40,132,2702,170,2089,65,659,2983
"073","Taranto",69,97,2365,38,128,2628,171,2078,57,699,3005
"073","Taranto",70,101,2479,44,162,2786,205,2010,52,817,3084
"073","Taranto",71,71,2414,18,173,2676,211,2064,47,863,3185
"073","Taranto",72,97,2376,20,194,2687,192,1968,39,1014,3213
"073","Taranto",73,58,2040,28,200,2326,163,1810,40,1044,3057
"073","Taranto",74,64,1990,22,212,2288,186,1557,26,1092,2861
"073","Taranto",75,61,1837,17,191,2106,163,1395,34,1024,2616
"073","Taranto",76,61,1736,18,213,2028,195,1267,32,1203,2697
"073","Taranto",77,54,1641,18,244,1957,202,1151,22,1296,2671
"073","Taranto",78,43,1470,9,236,1758,181,1023,25,1241,2470
"073","Taranto",79,39,1286,7,243,1575,165,843,29,1230,2267
"073","Taranto",80,50,1140,11,279,1480,204,762,29,1397,2392
"073","Taranto",81,66,1014,8,274,1362,171,732,19,1488,2410
"073","Taranto",82,44,885,9,250,1188,152,520,21,1284,1977
"073","Taranto",83,36,749,4,237,1026,122,462,17,1232,1833
"073","Taranto",84,43,733,6,232,1014,149,373,12,1159,1693
"073","Taranto",85,32,529,6,253,820,101,292,16,1143,1552
"073","Taranto",86,31,607,4,238,880,164,240,10,1026,1440
"073","Taranto",87,23,461,1,220,705,122,178,11,936,1247
"073","Taranto",88,18,402,2,197,619,96,129,9,759,993
"073","Taranto",89,18,280,4,209,511,86,94,12,747,939
"073","Taranto",90,9,208,1,163,381,74,73,5,604,756
"073","Taranto",91,8,153,2,117,280,58,40,1,433,532
"073","Taranto",92,4,67,0,63,134,39,22,0,224,285
"073","Taranto",93,8,37,1,38,84,23,11,2,162,198
"073","Taranto",94,2,23,0,33,58,25,8,2,131,166
"073","Taranto",95,0,18,0,34,52,18,14,0,126,158
"073","Taranto",96,4,24,0,43,71,16,3,1,110,130
"073","Taranto",97,2,16,0,19,37,9,1,1,81,92
"073","Taranto",98,0,5,0,11,16,5,3,0,65,73
"073","Taranto",99,0,5,0,9,14,5,2,0,32,39
"073","Taranto",100,0,4,0,20,24,4,3,0,55,62
"074","Brindisi",0,1717,0,0,0,1717,1552,0,0,0,1552
"074","Brindisi",1,1719,0,0,0,1719,1671,0,0,0,1671
"074","Brindisi",2,1878,0,0,0,1878,1713,0,0,0,1713
"074","Brindisi",3,1791,0,0,0,1791,1727,0,0,0,1727
"074","Brindisi",4,1867,0,0,0,1867,1658,0,0,0,1658
"074","Brindisi",5,1829,0,0,0,1829,1722,0,0,0,1722
"074","Brindisi",6,1833,0,0,0,1833,1757,0,0,0,1757
"074","Brindisi",7,1907,0,0,0,1907,1825,0,0,0,1825
"074","Brindisi",8,1913,0,0,0,1913,1754,0,0,0,1754
"074","Brindisi",9,1954,0,0,0,1954,1866,0,0,0,1866
"074","Brindisi",10,1963,0,0,0,1963,1910,0,0,0,1910
"074","Brindisi",11,1940,0,0,0,1940,2016,0,0,0,2016
"074","Brindisi",12,2087,0,0,0,2087,1961,0,0,0,1961
"074","Brindisi",13,2075,0,0,0,2075,1946,0,0,0,1946
"074","Brindisi",14,2019,0,0,0,2019,1946,0,0,0,1946
"074","Brindisi",15,2143,0,0,0,2143,2015,0,0,0,2015
"074","Brindisi",16,2062,0,0,0,2062,2036,0,0,0,2036
"074","Brindisi",17,2208,0,0,0,2208,2075,2,0,0,2077
"074","Brindisi",18,2391,0,0,0,2391,2183,7,0,0,2190
"074","Brindisi",19,2533,4,0,0,2537,2309,34,0,0,2343
"074","Brindisi",20,2401,11,0,0,2412,2333,63,0,0,2396
"074","Brindisi",21,2545,21,0,0,2566,2293,92,0,0,2385
"074","Brindisi",22,2468,27,1,0,2496,2250,143,0,0,2393
"074","Brindisi",23,2390,62,0,0,2452,2193,252,2,0,2447
"074","Brindisi",24,2386,102,0,0,2488,2198,293,1,0,2492
"074","Brindisi",25,2226,134,0,0,2360,1918,412,5,1,2336
"074","Brindisi",26,2311,213,0,0,2524,1890,613,6,0,2509
"074","Brindisi",27,2165,296,2,0,2463,1784,731,6,2,2523
"074","Brindisi",28,1966,442,3,0,2411,1532,926,6,0,2464
"074","Brindisi",29,1876,611,1,1,2489,1413,1137,5,5,2560
"074","Brindisi",30,1810,662,2,1,2475,1279,1169,11,5,2464
"074","Brindisi",31,1645,877,6,1,2529,1095,1373,14,3,2485
"074","Brindisi",32,1593,1112,2,0,2707,1050,1547,28,6,2631
"074","Brindisi",33,1456,1246,4,3,2709,995,1701,25,5,2726
"074","Brindisi",34,1364,1394,12,2,2772,881,1903,35,15,2834
"074","Brindisi",35,1261,1629,11,2,2903,889,1989,41,9,2928
"074","Brindisi",36,1129,1770,12,5,2916,816,2184,47,14,3061
"074","Brindisi",37,1097,1921,26,3,3047,735,2285,49,20,3089
"074","Brindisi",38,928,1886,29,5,2848,662,2242,51,24,2979
"074","Brindisi",39,819,1973,27,6,2825,595,2240,64,18,2917
"074","Brindisi",40,801,2024,46,6,2877,554,2314,69,26,2963
"074","Brindisi",41,675,2139,41,5,2860,548,2395,77,31,3051
"074","Brindisi",42,646,2187,52,5,2890,477,2476,81,40,3074
"074","Brindisi",43,601,2374,43,6,3024,466,2515,90,57,3128
"074","Brindisi",44,508,2409,50,7,2974,508,2519,93,55,3175
"074","Brindisi",45,558,2415,62,12,3047,448,2442,83,56,3029
"074","Brindisi",46,456,2456,77,12,3001,390,2639,90,63,3182
"074","Brindisi",47,442,2589,71,18,3120,440,2634,77,76,3227
"074","Brindisi",48,362,2452,59,14,2887,444,2560,99,88,3191
"074","Brindisi",49,320,2443,53,19,2835,402,2323,89,108,2922
"074","Brindisi",50,315,2381,59,14,2769,363,2530,75,110,3078
"074","Brindisi",51,254,2306,69,15,2644,337,2465,84,105,2991
"074","Brindisi",52,224,2362,58,23,2667,328,2285,88,117,2818
"074","Brindisi",53,222,2217,40,24,2503,280,2214,101,130,2725
"074","Brindisi",54,192,2240,68,11,2511,299,2230,93,140,2762
"074","Brindisi",55,193,2263,70,13,2539,287,2266,77,145,2775
"074","Brindisi",56,177,2162,53,31,2423,295,2170,85,184,2734
"074","Brindisi",57,180,2093,42,31,2346,246,1966,58,197,2467
"074","Brindisi",58,174,1995,41,39,2249,233,1956,64,219,2472
"074","Brindisi",59,138,2056,40,39,2273,277,2014,73,209,2573
"074","Brindisi",60,146,2029,44,45,2264,242,2102,60,263,2667
"074","Brindisi",61,134,2211,30,59,2434,254,2056,54,288,2652
"074","Brindisi",62,131,2261,37,57,2486,262,2134,55,342,2793
"074","Brindisi",63,125,2315,41,64,2545,272,2131,57,359,2819
"074","Brindisi",64,125,2164,31,77,2397,238,2014,51,392,2695
"074","Brindisi",65,114,2142,42,71,2369,243,1917,52,459,2671
"074","Brindisi",66,86,1758,27,67,1938,220,1532,41,409,2202
"074","Brindisi",67,86,1594,27,67,1774,240,1484,49,431,2204
"074","Brindisi",68,61,1695,28,77,1861,222,1437,42,477,2178
"074","Brindisi",69,107,1675,30,85,1897,197,1465,32,513,2207
"074","Brindisi",70,73,1552,23,103,1751,192,1273,30,520,2015
"074","Brindisi",71,77,1656,19,117,1869,207,1292,39,632,2170
"074","Brindisi",72,78,1706,14,128,1926,240,1352,31,716,2339
"074","Brindisi",73,72,1552,19,126,1769,224,1196,26,673,2119
"074","Brindisi",74,61,1454,8,137,1660,203,1045,27,745,2020
"074","Brindisi",75,59,1292,10,140,1501,185,945,30,736,1896
"074","Brindisi",76,59,1169,16,151,1395,171,812,21,805,1809
"074","Brindisi",77,56,1174,14,157,1401,222,810,15,875,1922
"074","Brindisi",78,37,1002,12,154,1205,194,677,24,904,1799
"074","Brindisi",79,42,933,6,170,1151,160,583,21,895,1659
"074","Brindisi",80,44,937,8,172,1161,193,559,16,954,1722
"074","Brindisi",81,32,900,7,212,1151,160,475,13,975,1623
"074","Brindisi",82,38,712,5,172,927,166,430,16,903,1515
"074","Brindisi",83,34,587,3,192,816,169,312,8,906,1395
"074","Brindisi",84,38,539,4,195,776,148,287,10,942,1387
"074","Brindisi",85,30,458,1,181,670,135,244,4,836,1219
"074","Brindisi",86,23,362,2,167,554,121,167,3,749,1040
"074","Brindisi",87,13,256,0,156,425,124,116,2,641,883
"074","Brindisi",88,18,235,0,171,424,100,99,6,622,827
"074","Brindisi",89,9,197,1,142,349,91,74,8,611,784
"074","Brindisi",90,10,149,0,130,289,74,48,2,481,605
"074","Brindisi",91,15,95,2,99,211,71,30,0,393,494
"074","Brindisi",92,3,54,1,41,99,35,21,4,238,298
"074","Brindisi",93,3,29,0,33,65,29,11,0,158,198
"074","Brindisi",94,2,29,0,27,58,21,2,2,111,136
"074","Brindisi",95,1,21,0,32,54,17,1,1,104,123
"074","Brindisi",96,4,14,0,29,47,15,5,1,97,118
"074","Brindisi",97,0,6,0,13,19,8,2,0,74,84
"074","Brindisi",98,1,9,0,12,22,9,1,1,55,66
"074","Brindisi",99,2,1,0,13,16,4,0,1,28,33
"074","Brindisi",100,2,5,0,12,19,11,3,1,53,68
"075","Lecce",0,3298,0,0,0,3298,3175,0,0,0,3175
"075","Lecce",1,3480,0,0,0,3480,3191,0,0,0,3191
"075","Lecce",2,3369,0,0,0,3369,3252,0,0,0,3252
"075","Lecce",3,3601,0,0,0,3601,3367,0,0,0,3367
"075","Lecce",4,3672,0,0,0,3672,3349,0,0,0,3349
"075","Lecce",5,3488,0,0,0,3488,3434,0,0,0,3434
"075","Lecce",6,3679,0,0,0,3679,3469,0,0,0,3469
"075","Lecce",7,3813,0,0,0,3813,3726,0,0,0,3726
"075","Lecce",8,3896,0,0,0,3896,3653,0,0,0,3653
"075","Lecce",9,3820,0,0,0,3820,3661,0,0,0,3661
"075","Lecce",10,4069,0,0,0,4069,3819,0,0,0,3819
"075","Lecce",11,4154,0,0,0,4154,3832,0,0,0,3832
"075","Lecce",12,3961,0,0,0,3961,3726,0,0,0,3726
"075","Lecce",13,4036,0,0,0,4036,3810,0,0,0,3810
"075","Lecce",14,3978,0,0,0,3978,3799,0,0,0,3799
"075","Lecce",15,3974,0,0,0,3974,3899,0,0,0,3899
"075","Lecce",16,4204,0,0,0,4204,3929,0,0,0,3929
"075","Lecce",17,4204,0,0,0,4204,4099,0,0,0,4099
"075","Lecce",18,4513,0,0,0,4513,4348,7,0,0,4355
"075","Lecce",19,4808,3,0,0,4811,4478,32,1,0,4511
"075","Lecce",20,4726,8,0,0,4734,4454,58,0,0,4512
"075","Lecce",21,4668,29,0,0,4697,4338,125,0,0,4463
"075","Lecce",22,4564,35,0,0,4599,4311,233,0,0,4544
"075","Lecce",23,4679,77,0,0,4756,4373,314,0,0,4687
"075","Lecce",24,4536,122,0,0,4658,4108,431,2,2,4543
"075","Lecce",25,4476,214,0,0,4690,3792,600,1,1,4394
"075","Lecce",26,4297,305,1,0,4603,3727,940,4,1,4672
"075","Lecce",27,4294,478,0,0,4772,3653,1150,7,2,4812
"075","Lecce",28,4151,622,0,0,4773,3280,1506,13,2,4801
"075","Lecce",29,3887,872,1,0,4760,3045,1809,11,5,4870
"075","Lecce",30,3675,1157,6,1,4839,2687,2290,16,4,4997
"075","Lecce",31,3469,1526,5,0,5000,2606,2570,17,7,5200
"075","Lecce",32,3330,1942,5,2,5279,2256,3082,31,6,5375
"075","Lecce",33,3084,2336,8,2,5430,2193,3372,24,13,5602
"075","Lecce",34,2858,2587,10,2,5457,1905,3778,35,20,5738
"075","Lecce",35,2684,3094,23,4,5805,1808,4086,60,19,5973
"075","Lecce",36,2441,3408,33,7,5889,1618,4184,61,35,5898
"075","Lecce",37,2182,3705,33,5,5925,1566,4449,69,25,6109
"075","Lecce",38,1884,3730,57,5,5676,1417,4460,102,36,6015
"075","Lecce",39,1700,3768,44,9,5521,1197,4380,104,36,5717
"075","Lecce",40,1631,4013,52,8,5704,1201,4568,91,62,5922
"075","Lecce",41,1385,4224,61,12,5682,1185,4629,129,69,6012
"075","Lecce",42,1313,4368,82,15,5778,1117,4885,129,73,6204
"075","Lecce",43,1212,4477,81,12,5782,1098,4997,139,71,6305
"075","Lecce",44,1119,4662,93,24,5898,1046,5057,148,71,6322
"075","Lecce",45,1050,4827,109,21,6007,1066,5190,173,93,6522
"075","Lecce",46,910,4779,100,27,5816,994,5166,188,110,6458
"075","Lecce",47,857,5051,123,32,6063,957,5257,165,110,6489
"075","Lecce",48,726,4760,110,31,5627,904,4910,153,123,6090
"075","Lecce",49,629,4682,117,32,5460,858,4807,153,152,5970
"075","Lecce",50,602,4583,102,37,5324,821,4716,146,172,5855
"075","Lecce",51,532,4595,118,33,5278,747,4672,169,207,5795
"075","Lecce",52,486,4452,105,50,5093,764,4532,122,194,5612
"075","Lecce",53,418,4052,117,40,4627,713,4286,140,249,5388
"075","Lecce",54,446,4276,107,58,4887,670,4434,153,252,5509
"075","Lecce",55,364,4310,97,53,4824,681,4343,119,298,5441
"075","Lecce",56,353,4388,99,72,4912,625,4370,135,335,5465
"075","Lecce",57,338,4159,91,58,4646,616,4132,115,375,5238
"075","Lecce",58,317,4243,102,75,4737,547,4248,146,396,5337
"075","Lecce",59,252,3951,65,62,4330,496,3862,121,426,4905
"075","Lecce",60,291,4379,91,87,4848,526,4181,115,534,5356
"075","Lecce",61,241,4499,83,89,4912,565,4137,129,558,5389
"075","Lecce",62,262,4289,76,102,4729,560,4050,118,632,5360
"075","Lecce",63,250,4606,80,138,5074,572,4387,117,726,5802
"075","Lecce",64,230,4513,85,167,4995,529,4126,101,810,5566
"075","Lecce",65,204,4416,82,143,4845,530,4024,108,871,5533
"075","Lecce",66,184,3704,53,134,4075,496,3169,104,765,4534
"075","Lecce",67,153,3299,53,140,3645,462,2839,71,759,4131
"075","Lecce",68,175,3530,58,161,3924,480,3083,62,893,4518
"075","Lecce",69,164,3541,49,203,3957,469,2977,60,1012,4518
"075","Lecce",70,163,3272,39,193,3667,482,2682,68,1079,4311
"075","Lecce",71,184,3401,43,224,3852,478,2779,64,1255,4576
"075","Lecce",72,158,3540,47,267,4012,504,2895,62,1471,4932
"075","Lecce",73,115,3307,46,297,3765,495,2674,50,1542,4761
"075","Lecce",74,124,2848,28,260,3260,462,2264,51,1476,4253
"075","Lecce",75,132,2763,23,284,3202,395,2091,37,1520,4043
"075","Lecce",76,113,2679,29,324,3145,444,1973,52,1694,4163
"075","Lecce",77,118,2501,22,310,2951,407,1787,29,1780,4003
"075","Lecce",78,91,2377,19,339,2826,420,1613,23,1876,3932
"075","Lecce",79,92,2129,12,374,2607,411,1510,32,1908,3861
"075","Lecce",80,93,2014,10,390,2507,401,1296,21,2029,3747
"075","Lecce",81,92,1990,9,435,2526,378,1250,32,2206,3866
"075","Lecce",82,83,1644,14,461,2202,390,948,25,2101,3464
"075","Lecce",83,51,1388,9,404,1852,369,777,19,1999,3164
"075","Lecce",84,50,1183,5,373,1611,327,647,21,1929,2924
"075","Lecce",85,44,937,9,363,1353,316,470,18,1734,2538
"075","Lecce",86,49,727,3,349,1128,266,350,12,1573,2201
"075","Lecce",87,23,602,0,322,947,246,279,14,1419,1958
"075","Lecce",88,31,474,1,278,784,206,215,7,1366,1794
"075","Lecce",89,12,383,2,261,658,193,137,7,1186,1523
"075","Lecce",90,22,253,2,202,479,144,85,7,925,1161
"075","Lecce",91,8,216,2,166,392,114,72,7,940,1133
"075","Lecce",92,15,93,0,104,212,73,36,2,499,610
"075","Lecce",93,6,68,1,69,144,56,12,3,322,393
"075","Lecce",94,6,39,0,56,101,41,8,1,254,304
"075","Lecce",95,3,29,2,39,73,41,5,2,250,298
"075","Lecce",96,0,31,0,61,92,36,10,1,216,263
"075","Lecce",97,3,18,0,43,64,34,8,0,168,210
"075","Lecce",98,2,9,0,26,37,18,3,0,117,138
"075","Lecce",99,0,9,0,10,19,16,1,0,92,109
"075","Lecce",100,2,7,1,16,26,17,3,0,137,157
"076","Potenza",0,1444,0,0,0,1444,1319,0,0,0,1319
"076","Potenza",1,1474,0,0,0,1474,1405,0,0,0,1405
"076","Potenza",2,1590,0,0,0,1590,1452,0,0,0,1452
"076","Potenza",3,1604,0,0,0,1604,1484,0,0,0,1484
"076","Potenza",4,1613,0,0,0,1613,1489,0,0,0,1489
"076","Potenza",5,1585,0,0,0,1585,1541,0,0,0,1541
"076","Potenza",6,1595,0,0,0,1595,1513,0,0,0,1513
"076","Potenza",7,1680,0,0,0,1680,1632,0,0,0,1632
"076","Potenza",8,1731,0,0,0,1731,1573,0,0,0,1573
"076","Potenza",9,1810,0,0,0,1810,1649,0,0,0,1649
"076","Potenza",10,1835,0,0,0,1835,1673,0,0,0,1673
"076","Potenza",11,1856,0,0,0,1856,1721,0,0,0,1721
"076","Potenza",12,1857,0,0,0,1857,1766,0,0,0,1766
"076","Potenza",13,1914,0,0,0,1914,1715,0,0,0,1715
"076","Potenza",14,1857,0,0,0,1857,1695,0,0,0,1695
"076","Potenza",15,1920,0,0,0,1920,1757,0,0,0,1757
"076","Potenza",16,1971,1,0,0,1972,1840,0,0,0,1840
"076","Potenza",17,2029,0,0,0,2029,1938,4,0,0,1942
"076","Potenza",18,2137,0,0,0,2137,1946,1,0,0,1947
"076","Potenza",19,2270,2,0,0,2272,2198,12,0,0,2210
"076","Potenza",20,2189,5,0,0,2194,2143,20,0,0,2163
"076","Potenza",21,2320,4,0,0,2324,2123,65,1,0,2189
"076","Potenza",22,2363,14,0,0,2377,2147,105,0,0,2252
"076","Potenza",23,2276,25,0,0,2301,2099,154,0,1,2254
"076","Potenza",24,2298,62,1,0,2361,2028,233,1,0,2262
"076","Potenza",25,2278,78,1,0,2357,1926,298,0,4,2228
"076","Potenza",26,2334,146,1,0,2481,1812,403,2,0,2217
"076","Potenza",27,2234,205,1,0,2440,1781,549,7,5,2342
"076","Potenza",28,2041,296,3,0,2340,1546,742,4,1,2293
"076","Potenza",29,1984,401,2,0,2387,1498,903,7,1,2409
"076","Potenza",30,1843,522,1,0,2366,1164,1070,10,2,2246
"076","Potenza",31,1627,676,6,0,2309,1074,1151,14,1,2240
"076","Potenza",32,1608,791,1,0,2400,949,1288,17,8,2262
"076","Potenza",33,1546,942,5,0,2493,810,1492,14,6,2322
"076","Potenza",34,1374,1096,4,1,2475,772,1661,27,3,2463
"076","Potenza",35,1332,1309,13,2,2656,783,1769,25,10,2587
"076","Potenza",36,1168,1443,8,1,2620,699,1955,33,7,2694
"076","Potenza",37,1105,1631,18,0,2754,628,1962,49,20,2659
"076","Potenza",38,939,1678,14,4,2635,567,2043,42,15,2667
"076","Potenza",39,896,1765,20,1,2682,551,2139,50,21,2761
"076","Potenza",40,822,1899,23,3,2747,493,2192,63,15,2763
"076","Potenza",41,716,2017,29,3,2765,465,2309,52,33,2859
"076","Potenza",42,728,2209,42,5,2984,456,2333,59,44,2892
"076","Potenza",43,683,2166,46,8,2903,436,2346,79,49,2910
"076","Potenza",44,599,2322,47,10,2978,383,2568,72,58,3081
"076","Potenza",45,581,2202,32,16,2831,383,2477,68,53,2981
"076","Potenza",46,595,2310,50,10,2965,378,2496,61,66,3001
"076","Potenza",47,526,2423,53,14,3016,375,2594,76,53,3098
"076","Potenza",48,459,2361,56,22,2898,346,2427,60,94,2927
"076","Potenza",49,469,2507,55,10,3041,324,2474,59,100,2957
"076","Potenza",50,384,2426,44,15,2869,290,2380,73,109,2852
"076","Potenza",51,342,2374,47,17,2780,301,2400,77,116,2894
"076","Potenza",52,360,2191,41,27,2619,293,2225,53,142,2713
"076","Potenza",53,291,2252,42,21,2606,287,2122,63,137,2609
"076","Potenza",54,303,2064,47,26,2440,237,2219,57,155,2668
"076","Potenza",55,260,2207,46,23,2536,236,2204,58,168,2666
"076","Potenza",56,232,2222,66,39,2559,212,2013,49,175,2449
"076","Potenza",57,225,2127,41,43,2436,231,2103,57,206,2597
"076","Potenza",58,228,2064,32,40,2364,202,1874,46,231,2353
"076","Potenza",59,185,1985,38,48,2256,216,1843,41,234,2334
"076","Potenza",60,175,1929,40,45,2189,147,1841,31,260,2279
"076","Potenza",61,154,2126,34,57,2371,168,1759,32,302,2261
"076","Potenza",62,155,2135,43,53,2386,170,1781,48,354,2353
"076","Potenza",63,153,2057,33,70,2313,181,1882,41,432,2536
"076","Potenza",64,149,1854,19,65,2087,167,1676,30,406,2279
"076","Potenza",65,127,1698,16,78,1919,149,1571,25,392,2137
"076","Potenza",66,91,1276,23,63,1453,136,1155,24,358,1673
"076","Potenza",67,99,1293,10,61,1463,113,1089,14,348,1564
"076","Potenza",68,97,1306,11,73,1487,109,1095,18,365,1587
"076","Potenza",69,85,1256,18,77,1436,93,1091,17,482,1683
"076","Potenza",70,90,1315,15,94,1514,105,1100,15,495,1715
"076","Potenza",71,111,1570,20,124,1825,133,1248,22,595,1998
"076","Potenza",72,100,1603,19,111,1833,144,1288,18,717,2167
"076","Potenza",73,68,1518,18,140,1744,133,1168,14,756,2071
"076","Potenza",74,102,1485,15,158,1760,150,1150,20,814,2134
"076","Potenza",75,81,1377,16,168,1642,134,1018,11,848,2011
"076","Potenza",76,79,1346,10,184,1619,148,989,14,901,2052
"076","Potenza",77,82,1279,6,175,1542,148,997,12,1004,2161
"076","Potenza",78,71,1287,11,221,1590,133,856,16,1058,2063
"076","Potenza",79,52,1102,4,219,1377,148,700,13,977,1838
"076","Potenza",80,68,960,4,223,1255,122,683,11,1035,1851
"076","Potenza",81,65,1034,4,227,1330,124,631,5,1096,1856
"076","Potenza",82,47,812,6,228,1093,137,509,8,1031,1685
"076","Potenza",83,37,766,5,256,1064,104,399,2,997,1502
"076","Potenza",84,45,638,5,224,912,107,383,8,952,1450
"076","Potenza",85,28,536,3,244,811,100,289,8,949,1346
"076","Potenza",86,24,420,1,214,659,88,222,3,797,1110
"076","Potenza",87,17,338,1,209,565,86,146,4,751,987
"076","Potenza",88,10,312,2,172,496,91,142,1,708,942
"076","Potenza",89,11,233,1,154,399,60,112,2,649,823
"076","Potenza",90,13,146,1,128,288,53,60,5,585,703
"076","Potenza",91,11,131,1,120,263,38,48,1,460,547
"076","Potenza",92,7,55,0,55,117,20,19,1,244,284
"076","Potenza",93,3,33,0,30,66,19,11,0,144,174
"076","Potenza",94,5,32,0,33,70,19,5,0,129,153
"076","Potenza",95,1,17,0,26,44,7,3,0,148,158
"076","Potenza",96,0,24,0,46,70,13,3,0,137,153
"076","Potenza",97,1,10,0,33,44,8,4,0,97,109
"076","Potenza",98,1,9,1,19,30,4,2,2,61,69
"076","Potenza",99,0,3,0,13,16,5,1,0,49,55
"076","Potenza",100,0,1,0,28,29,8,2,0,55,65
"077","Matera",0,819,0,0,0,819,800,0,0,0,800
"077","Matera",1,821,0,0,0,821,819,0,0,0,819
"077","Matera",2,840,0,0,0,840,793,0,0,0,793
"077","Matera",3,908,0,0,0,908,850,0,0,0,850
"077","Matera",4,884,0,0,0,884,832,0,0,0,832
"077","Matera",5,978,0,0,0,978,821,0,0,0,821
"077","Matera",6,921,0,0,0,921,855,0,0,0,855
"077","Matera",7,947,0,0,0,947,990,0,0,0,990
"077","Matera",8,1008,0,0,0,1008,929,0,0,0,929
"077","Matera",9,987,0,0,0,987,956,0,0,0,956
"077","Matera",10,1014,0,0,0,1014,927,0,0,0,927
"077","Matera",11,1117,0,0,0,1117,934,0,0,0,934
"077","Matera",12,1020,0,0,0,1020,948,0,0,0,948
"077","Matera",13,1028,0,0,0,1028,920,0,0,0,920
"077","Matera",14,1035,0,0,0,1035,1019,0,0,0,1019
"077","Matera",15,1048,0,0,0,1048,1019,0,0,0,1019
"077","Matera",16,1030,0,0,0,1030,1003,0,0,0,1003
"077","Matera",17,1050,0,0,0,1050,1041,3,0,0,1044
"077","Matera",18,1119,0,0,0,1119,1075,2,0,0,1077
"077","Matera",19,1229,3,0,0,1232,1111,10,0,0,1121
"077","Matera",20,1225,1,0,0,1226,1145,19,0,0,1164
"077","Matera",21,1298,3,0,0,1301,1177,50,0,0,1227
"077","Matera",22,1237,11,0,0,1248,1097,75,0,0,1172
"077","Matera",23,1186,20,0,0,1206,1117,91,2,0,1210
"077","Matera",24,1255,38,0,0,1293,1036,140,1,1,1178
"077","Matera",25,1172,48,1,0,1221,967,174,4,0,1145
"077","Matera",26,1158,75,0,0,1233,977,271,0,1,1249
"077","Matera",27,1176,121,0,0,1297,892,329,3,0,1224
"077","Matera",28,1162,151,1,0,1314,834,426,0,0,1260
"077","Matera",29,1014,249,1,1,1265,748,515,2,2,1267
"077","Matera",30,1019,327,0,0,1346,690,585,5,3,1283
"077","Matera",31,920,408,2,1,1331,591,658,5,2,1256
"077","Matera",32,871,444,3,2,1320,524,741,6,6,1277
"077","Matera",33,871,563,0,0,1434,467,857,9,1,1334
"077","Matera",34,733,621,1,0,1355,467,970,11,1,1449
"077","Matera",35,704,781,3,0,1488,402,969,17,9,1397
"077","Matera",36,630,812,3,1,1446,362,1064,13,10,1449
"077","Matera",37,602,921,8,1,1532,317,1119,22,9,1467
"077","Matera",38,521,962,8,3,1494,321,1068,16,12,1417
"077","Matera",39,464,1015,7,2,1488,255,1168,21,13,1457
"077","Matera",40,466,952,16,2,1436,246,1160,24,19,1449
"077","Matera",41,385,1059,13,4,1461,238,1229,18,13,1498
"077","Matera",42,346,1041,22,5,1414,223,1172,33,33,1461
"077","Matera",43,317,1143,16,1,1477,228,1240,25,18,1511
"077","Matera",44,320,1129,12,6,1467,193,1253,31,27,1504
"077","Matera",45,273,1155,19,8,1455,195,1305,25,32,1557
"077","Matera",46,268,1181,17,5,1471,183,1299,29,31,1542
"077","Matera",47,227,1286,21,8,1542,197,1316,33,32,1578
"077","Matera",48,214,1244,25,11,1494,173,1218,23,42,1456
"077","Matera",49,178,1217,29,3,1427,166,1262,11,45,1484
"077","Matera",50,189,1146,25,11,1371,143,1311,20,48,1522
"077","Matera",51,156,1177,18,8,1359,151,1222,29,68,1470
"077","Matera",52,162,1195,23,10,1390,156,1213,18,55,1442
"077","Matera",53,137,1184,20,6,1347,120,1173,31,79,1403
"077","Matera",54,137,1083,14,9,1243,132,1185,33,82,1432
"077","Matera",55,124,1197,20,11,1352,139,1148,27,87,1401
"077","Matera",56,123,1155,12,10,1300,106,1128,33,79,1346
"077","Matera",57,98,1169,18,18,1303,100,1131,18,92,1341
"077","Matera",58,77,1074,20,20,1191,100,989,11,115,1215
"077","Matera",59,79,1043,16,23,1161,106,1006,21,136,1269
"077","Matera",60,72,1040,14,21,1147,91,998,21,131,1241
"077","Matera",61,86,1096,18,23,1223,88,1053,22,150,1313
"077","Matera",62,72,1139,13,26,1250,70,1071,17,164,1322
"077","Matera",63,80,1227,14,29,1350,102,1066,13,208,1389
"077","Matera",64,67,1067,15,44,1193,89,920,18,195,1222
"077","Matera",65,56,993,12,33,1094,74,799,11,201,1085
"077","Matera",66,46,789,13,25,873,72,688,11,192,963
"077","Matera",67,41,787,14,36,878,66,662,6,188,922
"077","Matera",68,32,750,6,38,826,60,614,8,228,910
"077","Matera",69,50,745,7,35,837,78,590,5,274,947
"077","Matera",70,32,698,8,37,775,63,556,10,269,898
"077","Matera",71,45,845,6,62,958,77,660,6,354,1097
"077","Matera",72,39,813,5,78,935,74,666,5,369,1114
"077","Matera",73,41,760,3,63,867,69,662,5,361,1097
"077","Matera",74,45,757,6,72,880,68,565,10,420,1063
"077","Matera",75,50,702,5,70,827,71,526,7,450,1054
"077","Matera",76,37,670,2,82,791,54,511,4,446,1015
"077","Matera",77,24,690,7,94,815,56,417,5,481,959
"077","Matera",78,32,607,2,84,725,62,425,5,495,987
"077","Matera",79,28,582,3,100,713,68,333,1,463,865
"077","Matera",80,18,516,1,92,627,47,288,2,472,809
"077","Matera",81,25,491,2,113,631,72,276,2,553,903
"077","Matera",82,16,383,3,107,509,56,198,3,471,728
"077","Matera",83,20,388,3,100,511,45,201,1,459,706
"077","Matera",84,14,374,2,103,493,54,134,1,493,682
"077","Matera",85,10,262,3,109,384,48,129,2,396,575
"077","Matera",86,16,243,0,117,376,34,98,4,364,500
"077","Matera",87,7,182,1,96,286,39,53,2,310,404
"077","Matera",88,10,162,1,82,255,31,56,3,308,398
"077","Matera",89,6,133,1,59,199,25,40,0,304,369
"077","Matera",90,1,85,1,58,145,28,28,0,238,294
"077","Matera",91,5,74,0,48,127,20,13,1,226,260
"077","Matera",92,1,33,0,29,63,13,14,0,108,135
"077","Matera",93,1,16,0,23,40,10,5,0,62,77
"077","Matera",94,0,15,0,13,28,4,2,1,60,67
"077","Matera",95,1,15,0,16,32,2,3,1,51,57
"077","Matera",96,1,11,1,17,30,2,1,0,38,41
"077","Matera",97,0,6,0,11,17,4,1,1,34,40
"077","Matera",98,1,5,0,5,11,4,2,0,21,27
"077","Matera",99,1,4,1,4,10,4,0,0,15,19
"077","Matera",100,0,3,0,16,19,0,1,0,20,21
"078","Cosenza",0,3025,0,0,0,3025,2853,0,0,0,2853
"078","Cosenza",1,2953,0,0,0,2953,2862,0,0,0,2862
"078","Cosenza",2,3198,0,0,0,3198,3029,0,0,0,3029
"078","Cosenza",3,3078,0,0,0,3078,3032,0,0,0,3032
"078","Cosenza",4,3102,0,0,0,3102,2939,0,0,0,2939
"078","Cosenza",5,3291,0,0,0,3291,3021,0,0,0,3021
"078","Cosenza",6,3254,0,0,0,3254,2981,0,0,0,2981
"078","Cosenza",7,3319,0,0,0,3319,3114,0,0,0,3114
"078","Cosenza",8,3300,0,0,0,3300,3176,0,0,0,3176
"078","Cosenza",9,3395,0,0,0,3395,3078,0,0,0,3078
"078","Cosenza",10,3309,0,0,0,3309,3196,0,0,0,3196
"078","Cosenza",11,3399,0,0,0,3399,3184,0,0,0,3184
"078","Cosenza",12,3327,0,0,0,3327,3208,0,0,0,3208
"078","Cosenza",13,3453,0,0,0,3453,3301,0,0,0,3301
"078","Cosenza",14,3433,0,0,0,3433,3318,0,0,0,3318
"078","Cosenza",15,3682,0,0,0,3682,3346,0,0,0,3346
"078","Cosenza",16,3605,0,0,0,3605,3422,1,0,0,3423
"078","Cosenza",17,3906,2,0,0,3908,3624,0,0,0,3624
"078","Cosenza",18,4191,0,0,0,4191,3785,13,0,0,3798
"078","Cosenza",19,4210,4,0,0,4214,4062,33,0,0,4095
"078","Cosenza",20,4320,10,0,0,4330,3943,76,0,0,4019
"078","Cosenza",21,4319,22,0,0,4341,4082,142,1,0,4225
"078","Cosenza",22,4512,36,0,0,4548,4265,292,0,1,4558
"078","Cosenza",23,4540,90,0,0,4630,4184,408,2,0,4594
"078","Cosenza",24,4479,125,1,0,4605,3948,540,1,0,4489
"078","Cosenza",25,4277,231,1,2,4511,3795,766,3,4,4568
"078","Cosenza",26,4354,366,0,0,4720,3569,1008,8,5,4590
"078","Cosenza",27,4225,577,0,0,4802,3324,1281,11,4,4620
"078","Cosenza",28,4080,712,2,1,4795,2938,1590,13,3,4544
"078","Cosenza",29,3722,927,2,0,4651,2719,1963,15,4,4701
"078","Cosenza",30,3585,1212,1,0,4798,2436,2231,22,7,4696
"078","Cosenza",31,3244,1480,4,3,4731,2173,2485,33,15,4706
"078","Cosenza",32,3001,1805,9,1,4816,1898,2803,38,9,4748
"078","Cosenza",33,2704,2160,14,0,4878,1714,3058,61,12,4845
"078","Cosenza",34,2600,2375,16,1,4992,1599,3363,54,16,5032
"078","Cosenza",35,2443,2615,20,5,5083,1469,3581,66,23,5139
"078","Cosenza",36,2204,2981,26,1,5212,1286,3716,82,24,5108
"078","Cosenza",37,1870,3119,32,4,5025,1192,3919,92,26,5229
"078","Cosenza",38,1777,3224,44,5,5050,1080,3950,110,40,5180
"078","Cosenza",39,1609,3452,50,11,5122,1019,4115,106,34,5274
"078","Cosenza",40,1540,3484,56,5,5085,902,4274,135,61,5372
"078","Cosenza",41,1362,3670,58,9,5099,902,4208,141,62,5313
"078","Cosenza",42,1353,3888,83,10,5334,893,4604,137,78,5712
"078","Cosenza",43,1280,3903,72,10,5265,875,4433,179,88,5575
"078","Cosenza",44,1120,4139,98,15,5372,786,4560,164,82,5592
"078","Cosenza",45,1051,4172,95,16,5334,799,4470,151,108,5528
"078","Cosenza",46,970,4221,86,19,5296,741,4604,143,124,5612
"078","Cosenza",47,941,4443,107,38,5529,743,4827,190,132,5892
"078","Cosenza",48,905,4275,93,27,5300,654,4469,172,171,5466
"078","Cosenza",49,795,4333,87,33,5248,616,4554,151,186,5507
"078","Cosenza",50,753,4360,97,38,5248,600,4546,138,208,5492
"078","Cosenza",51,685,4271,111,40,5107,585,4484,162,227,5458
"078","Cosenza",52,646,4372,88,34,5140,557,4292,128,271,5248
"078","Cosenza",53,615,3947,104,40,4706,505,4043,154,290,4992
"078","Cosenza",54,517,4222,103,50,4892,514,4076,145,302,5037
"078","Cosenza",55,515,4039,85,54,4693,472,4050,141,329,4992
"078","Cosenza",56,495,4043,90,54,4682,444,4004,121,403,4972
"078","Cosenza",57,412,4184,102,64,4762,412,3838,119,411,4780
"078","Cosenza",58,348,3862,95,73,4378,371,3636,120,463,4590
"078","Cosenza",59,342,3700,79,72,4193,340,3519,122,447,4428
"078","Cosenza",60,369,3772,66,79,4286,374,3575,113,508,4570
"078","Cosenza",61,307,3888,67,94,4356,343,3512,102,562,4519
"078","Cosenza",62,322,3966,91,113,4492,338,3540,95,612,4585
"078","Cosenza",63,288,3962,69,97,4416,325,3548,88,708,4669
"078","Cosenza",64,268,3844,73,114,4299,344,3350,90,802,4586
"078","Cosenza",65,294,3488,56,137,3975,306,3003,69,780,4158
"078","Cosenza",66,162,2669,45,121,2997,218,2219,43,631,3111
"078","Cosenza",67,200,2794,38,119,3151,234,2233,41,767,3275
"078","Cosenza",68,181,2671,41,143,3036,248,2152,42,837,3279
"078","Cosenza",69,166,2643,45,147,3001,215,2090,42,863,3210
"078","Cosenza",70,152,2611,32,158,2953,200,1990,43,879,3112
"078","Cosenza",71,171,2976,39,221,3407,217,2290,48,1174,3729
"078","Cosenza",72,170,2955,43,215,3383,258,2169,49,1249,3725
"078","Cosenza",73,164,2722,27,251,3164,243,2078,43,1314,3678
"078","Cosenza",74,129,2615,31,276,3051,247,1914,37,1356,3554
"078","Cosenza",75,152,2480,25,285,2942,263,1729,32,1480,3504
"078","Cosenza",76,153,2461,26,305,2945,242,1673,38,1556,3509
"078","Cosenza",77,136,2292,21,326,2775,237,1506,40,1568,3351
"078","Cosenza",78,135,2083,15,373,2606,255,1334,28,1691,3308
"078","Cosenza",79,78,1962,15,366,2421,266,1240,26,1725,3257
"078","Cosenza",80,94,1797,14,379,2284,235,1111,27,1695,3068
"078","Cosenza",81,85,1666,11,382,2144,219,1029,22,1701,2971
"078","Cosenza",82,99,1426,10,399,1934,199,809,37,1688,2733
"078","Cosenza",83,74,1188,17,371,1650,207,660,21,1527,2415
"078","Cosenza",84,45,1025,6,370,1446,184,579,9,1548,2320
"078","Cosenza",85,66,906,12,358,1342,194,450,16,1411,2071
"078","Cosenza",86,56,748,3,296,1103,187,392,12,1313,1904
"078","Cosenza",87,30,593,6,298,927,173,303,12,1227,1715
"078","Cosenza",88,35,431,4,267,737,151,211,12,1135,1509
"078","Cosenza",89,20,358,4,233,615,117,159,7,923,1206
"078","Cosenza",90,22,264,5,216,507,106,110,7,798,1021
"078","Cosenza",91,18,213,5,149,385,99,88,7,659,853
"078","Cosenza",92,5,115,0,98,218,60,54,3,343,460
"078","Cosenza",93,6,59,2,64,131,39,29,8,253,329
"078","Cosenza",94,7,53,2,56,118,30,25,2,233,290
"078","Cosenza",95,8,47,0,64,119,36,23,1,191,251
"078","Cosenza",96,6,30,0,46,82,18,16,1,167,202
"078","Cosenza",97,5,30,0,41,76,12,21,2,151,186
"078","Cosenza",98,2,31,0,25,58,9,13,1,103,126
"078","Cosenza",99,4,12,0,23,39,5,18,0,67,90
"078","Cosenza",100,2,19,0,22,43,15,11,0,80,106
"079","Catanzaro",0,1583,0,0,0,1583,1465,0,0,0,1465
"079","Catanzaro",1,1547,0,0,0,1547,1544,0,0,0,1544
"079","Catanzaro",2,1557,0,0,0,1557,1460,0,0,0,1460
"079","Catanzaro",3,1530,0,0,0,1530,1590,0,0,0,1590
"079","Catanzaro",4,1664,0,0,0,1664,1502,0,0,0,1502
"079","Catanzaro",5,1722,0,0,0,1722,1508,0,0,0,1508
"079","Catanzaro",6,1587,0,0,0,1587,1526,0,0,0,1526
"079","Catanzaro",7,1706,0,0,0,1706,1603,0,0,0,1603
"079","Catanzaro",8,1691,0,0,0,1691,1641,0,0,0,1641
"079","Catanzaro",9,1713,0,0,0,1713,1565,0,0,0,1565
"079","Catanzaro",10,1746,0,0,0,1746,1744,0,0,0,1744
"079","Catanzaro",11,1783,0,0,0,1783,1755,0,0,0,1755
"079","Catanzaro",12,1706,0,0,0,1706,1788,0,0,0,1788
"079","Catanzaro",13,1849,0,0,0,1849,1776,0,0,0,1776
"079","Catanzaro",14,1844,0,0,0,1844,1764,0,0,0,1764
"079","Catanzaro",15,1867,0,0,0,1867,1782,0,0,0,1782
"079","Catanzaro",16,1916,0,0,0,1916,1938,0,0,0,1938
"079","Catanzaro",17,1989,0,0,0,1989,1904,2,0,0,1906
"079","Catanzaro",18,2085,2,0,0,2087,2029,9,0,0,2038
"079","Catanzaro",19,2214,5,0,0,2219,2175,21,0,0,2196
"079","Catanzaro",20,2277,8,0,0,2285,2173,46,0,0,2219
"079","Catanzaro",21,2354,22,0,0,2376,2142,85,0,0,2227
"079","Catanzaro",22,2319,23,0,0,2342,2065,128,0,1,2194
"079","Catanzaro",23,2393,45,1,0,2439,2127,224,2,0,2353
"079","Catanzaro",24,2260,81,0,0,2341,1966,342,2,0,2310
"079","Catanzaro",25,2233,141,0,0,2374,1794,440,1,0,2235
"079","Catanzaro",26,2216,181,0,0,2397,1763,552,2,2,2319
"079","Catanzaro",27,2160,320,0,0,2480,1660,730,5,1,2396
"079","Catanzaro",28,1959,402,0,0,2361,1470,954,4,0,2428
"079","Catanzaro",29,1786,564,2,0,2352,1367,1035,9,5,2416
"079","Catanzaro",30,1687,674,1,1,2363,1147,1137,11,7,2302
"079","Catanzaro",31,1513,788,5,2,2308,1012,1297,15,5,2329
"079","Catanzaro",32,1364,935,6,0,2305,955,1427,15,4,2401
"079","Catanzaro",33,1317,1146,5,2,2470,796,1548,21,10,2375
"079","Catanzaro",34,1196,1229,10,2,2437,780,1678,22,7,2487
"079","Catanzaro",35,1073,1419,7,0,2499,698,1822,30,14,2564
"079","Catanzaro",36,1030,1422,9,4,2465,611,1781,37,19,2448
"079","Catanzaro",37,970,1560,18,3,2551,572,1908,43,21,2544
"079","Catanzaro",38,904,1529,18,3,2454,489,1977,40,20,2526
"079","Catanzaro",39,770,1637,24,8,2439,460,2040,58,28,2586
"079","Catanzaro",40,679,1736,25,2,2442,464,2166,59,26,2715
"079","Catanzaro",41,671,1853,27,5,2556,473,2188,59,24,2744
"079","Catanzaro",42,626,1969,36,5,2636,440,2222,70,29,2761
"079","Catanzaro",43,548,2024,31,6,2609,419,2222,67,50,2758
"079","Catanzaro",44,530,1989,43,5,2567,386,2290,69,68,2813
"079","Catanzaro",45,541,2041,47,9,2638,384,2386,56,68,2894
"079","Catanzaro",46,444,2077,35,13,2569,357,2272,77,63,2769
"079","Catanzaro",47,496,2213,52,9,2770,372,2463,78,79,2992
"079","Catanzaro",48,399,2159,45,16,2619,304,2392,70,87,2853
"079","Catanzaro",49,383,2123,49,15,2570,330,2368,73,78,2849
"079","Catanzaro",50,339,2104,57,16,2516,316,2240,76,106,2738
"079","Catanzaro",51,369,2219,57,15,2660,276,2247,78,128,2729
"079","Catanzaro",52,316,2116,51,23,2506,271,2162,73,144,2650
"079","Catanzaro",53,299,2015,52,29,2395,246,2040,72,145,2503
"079","Catanzaro",54,266,2110,45,24,2445,232,2108,65,150,2555
"079","Catanzaro",55,259,2111,40,31,2441,214,2000,63,176,2453
"079","Catanzaro",56,251,2112,41,26,2430,179,1954,71,215,2419
"079","Catanzaro",57,225,2084,46,34,2389,206,2010,49,190,2455
"079","Catanzaro",58,219,2072,49,34,2374,194,1784,59,212,2249
"079","Catanzaro",59,148,1929,45,39,2161,171,1649,51,238,2109
"079","Catanzaro",60,151,1928,41,44,2164,189,1789,52,273,2303
"079","Catanzaro",61,173,1896,41,49,2159,208,1780,51,296,2335
"079","Catanzaro",62,140,1984,38,40,2202,172,1673,55,335,2235
"079","Catanzaro",63,154,1917,34,64,2169,171,1718,43,369,2301
"079","Catanzaro",64,141,1945,41,60,2187,156,1620,34,399,2209
"079","Catanzaro",65,135,1785,34,73,2027,152,1533,38,413,2136
"079","Catanzaro",66,87,1411,27,40,1565,128,1119,30,350,1627
"079","Catanzaro",67,88,1424,19,60,1591,125,1086,26,385,1622
"079","Catanzaro",68,87,1407,29,76,1599,121,1081,25,455,1682
"079","Catanzaro",69,80,1367,19,80,1546,108,1102,25,481,1716
"079","Catanzaro",70,84,1233,19,74,1410,123,993,26,450,1592
"079","Catanzaro",71,80,1396,15,93,1584,128,1079,28,609,1844
"079","Catanzaro",72,78,1317,16,110,1521,132,1040,25,577,1774
"079","Catanzaro",73,69,1253,19,105,1446,122,922,17,628,1689
"079","Catanzaro",74,67,1311,14,92,1484,132,855,23,672,1682
"079","Catanzaro",75,53,1148,10,112,1323,112,807,22,745,1686
"079","Catanzaro",76,69,1071,14,142,1296,126,831,29,754,1740
"079","Catanzaro",77,44,1158,9,148,1359,135,712,13,831,1691
"079","Catanzaro",78,64,1080,4,160,1308,122,689,14,855,1680
"079","Catanzaro",79,43,929,11,157,1140,128,630,11,905,1674
"079","Catanzaro",80,46,876,6,182,1110,116,510,11,970,1607
"079","Catanzaro",81,44,835,7,165,1051,138,473,20,886,1517
"079","Catanzaro",82,39,661,5,168,873,120,396,10,849,1375
"079","Catanzaro",83,27,578,9,171,785,102,314,9,851,1276
"079","Catanzaro",84,25,478,2,155,660,116,249,6,803,1174
"079","Catanzaro",85,36,423,1,162,622,104,222,6,776,1108
"079","Catanzaro",86,17,347,1,194,559,98,168,4,749,1019
"079","Catanzaro",87,14,298,1,130,443,83,160,7,602,852
"079","Catanzaro",88,14,248,2,143,407,71,95,9,552,727
"079","Catanzaro",89,12,165,2,107,286,67,67,7,470,611
"079","Catanzaro",90,10,131,3,100,244,46,54,0,460,560
"079","Catanzaro",91,9,99,1,77,186,48,46,10,437,541
"079","Catanzaro",92,2,51,1,46,100,31,14,1,223,269
"079","Catanzaro",93,6,36,0,42,84,14,13,4,118,149
"079","Catanzaro",94,2,24,0,27,53,13,14,1,106,134
"079","Catanzaro",95,4,13,1,24,42,15,6,1,104,126
"079","Catanzaro",96,2,13,1,37,53,10,6,1,107,124
"079","Catanzaro",97,1,11,0,16,28,6,6,0,61,73
"079","Catanzaro",98,1,11,0,15,27,12,7,0,58,77
"079","Catanzaro",99,1,9,0,12,22,4,6,0,43,53
"079","Catanzaro",100,1,9,0,14,24,9,5,0,45,59
"080","Reggio di Calabria",0,2514,0,0,0,2514,2413,0,0,0,2413
"080","Reggio di Calabria",1,2717,0,0,0,2717,2528,0,0,0,2528
"080","Reggio di Calabria",2,2722,0,0,0,2722,2511,0,0,0,2511
"080","Reggio di Calabria",3,2647,0,0,0,2647,2585,0,0,0,2585
"080","Reggio di Calabria",4,2743,0,0,0,2743,2604,0,0,0,2604
"080","Reggio di Calabria",5,2800,0,0,0,2800,2595,0,0,0,2595
"080","Reggio di Calabria",6,2753,0,0,0,2753,2627,0,0,0,2627
"080","Reggio di Calabria",7,2782,0,0,0,2782,2533,0,0,0,2533
"080","Reggio di Calabria",8,2754,0,0,0,2754,2562,0,0,0,2562
"080","Reggio di Calabria",9,2712,0,0,0,2712,2595,0,0,0,2595
"080","Reggio di Calabria",10,2820,0,0,0,2820,2705,0,0,0,2705
"080","Reggio di Calabria",11,2923,0,0,0,2923,2782,0,0,0,2782
"080","Reggio di Calabria",12,2925,0,0,0,2925,2780,0,0,0,2780
"080","Reggio di Calabria",13,2886,0,0,0,2886,2914,0,0,0,2914
"080","Reggio di Calabria",14,2914,0,0,0,2914,2826,0,0,0,2826
"080","Reggio di Calabria",15,3008,0,0,0,3008,2899,0,0,0,2899
"080","Reggio di Calabria",16,3092,1,0,0,3093,3088,0,0,0,3088
"080","Reggio di Calabria",17,3251,0,0,0,3251,2974,2,0,1,2977
"080","Reggio di Calabria",18,3428,1,0,0,3429,3244,21,0,0,3265
"080","Reggio di Calabria",19,3453,2,0,0,3455,3345,48,1,0,3394
"080","Reggio di Calabria",20,3502,8,0,0,3510,3254,101,1,0,3356
"080","Reggio di Calabria",21,3616,19,0,0,3635,3205,179,0,2,3386
"080","Reggio di Calabria",22,3706,61,1,1,3769,3187,343,1,1,3532
"080","Reggio di Calabria",23,3680,102,1,0,3783,3170,482,0,1,3653
"080","Reggio di Calabria",24,3544,167,2,0,3713,3042,733,6,2,3783
"080","Reggio di Calabria",25,3489,254,2,0,3745,2800,819,3,4,3626
"080","Reggio di Calabria",26,3263,391,0,0,3654,2557,1033,3,1,3594
"080","Reggio di Calabria",27,3167,525,4,0,3696,2330,1280,4,2,3616
"080","Reggio di Calabria",28,2938,723,2,0,3663,2150,1462,11,5,3628
"080","Reggio di Calabria",29,2900,883,0,0,3783,1925,1742,17,7,3691
"080","Reggio di Calabria",30,2624,1134,1,0,3759,1688,1902,22,5,3617
"080","Reggio di Calabria",31,2403,1344,3,1,3751,1588,2124,28,7,3747
"080","Reggio di Calabria",32,2195,1552,5,2,3754,1367,2377,23,5,3772
"080","Reggio di Calabria",33,1963,1727,4,2,3696,1177,2360,43,14,3594
"080","Reggio di Calabria",34,1709,1941,11,1,3662,1181,2656,45,18,3900
"080","Reggio di Calabria",35,1739,2239,20,5,4003,1073,2871,48,17,4009
"080","Reggio di Calabria",36,1549,2259,20,1,3829,960,2989,56,25,4030
"080","Reggio di Calabria",37,1446,2400,28,4,3878,916,3031,61,25,4033
"080","Reggio di Calabria",38,1367,2467,22,5,3861,813,2997,79,30,3919
"080","Reggio di Calabria",39,1157,2451,33,4,3645,792,3127,65,40,4024
"080","Reggio di Calabria",40,1070,2726,35,4,3835,734,3163,93,43,4033
"080","Reggio di Calabria",41,996,2645,46,5,3692,674,3082,86,59,3901
"080","Reggio di Calabria",42,971,2865,43,12,3891,661,3335,83,73,4152
"080","Reggio di Calabria",43,915,2982,53,9,3959,693,3266,99,65,4123
"080","Reggio di Calabria",44,869,2952,41,10,3872,626,3305,96,84,4111
"080","Reggio di Calabria",45,784,2962,61,16,3823,563,3459,101,107,4230
"080","Reggio di Calabria",46,730,3081,77,15,3903,545,3387,125,120,4177
"080","Reggio di Calabria",47,727,3177,68,15,3987,571,3433,109,135,4248
"080","Reggio di Calabria",48,644,3032,52,19,3747,482,3277,124,147,4030
"080","Reggio di Calabria",49,620,3103,71,15,3809,484,3233,94,157,3968
"080","Reggio di Calabria",50,575,3053,51,19,3698,444,3274,110,214,4042
"080","Reggio di Calabria",51,557,3025,54,23,3659,459,3128,106,233,3926
"080","Reggio di Calabria",52,512,3048,69,27,3656,414,3095,97,228,3834
"080","Reggio di Calabria",53,476,2821,44,24,3365,379,2866,110,218,3573
"080","Reggio di Calabria",54,426,2990,63,37,3516,372,2921,118,278,3689
"080","Reggio di Calabria",55,381,2849,49,38,3317,317,2847,92,298,3554
"080","Reggio di Calabria",56,397,2915,58,41,3411,325,2829,92,307,3553
"080","Reggio di Calabria",57,360,2917,69,43,3389,297,2849,82,337,3565
"080","Reggio di Calabria",58,334,2731,57,42,3164,322,2565,93,336,3316
"080","Reggio di Calabria",59,288,2633,61,41,3023,269,2411,61,384,3125
"080","Reggio di Calabria",60,307,2692,55,55,3109,263,2492,79,463,3297
"080","Reggio di Calabria",61,272,2829,45,68,3214,285,2519,74,492,3370
"080","Reggio di Calabria",62,272,2786,53,82,3193,291,2414,55,505,3265
"080","Reggio di Calabria",63,268,2913,40,87,3308,248,2564,49,595,3456
"080","Reggio di Calabria",64,261,2862,49,88,3260,235,2484,78,614,3411
"080","Reggio di Calabria",65,228,2602,28,91,2949,228,2105,55,764,3152
"080","Reggio di Calabria",66,169,2108,35,90,2402,218,1728,59,572,2577
"080","Reggio di Calabria",67,165,2036,33,110,2344,191,1652,40,600,2483
"080","Reggio di Calabria",68,149,2134,27,108,2418,212,1605,38,723,2578
"080","Reggio di Calabria",69,159,2080,27,135,2401,200,1527,32,744,2503
"080","Reggio di Calabria",70,171,1992,33,126,2322,189,1563,34,798,2584
"080","Reggio di Calabria",71,173,2137,31,162,2503,244,1565,33,911,2753
"080","Reggio di Calabria",72,165,2065,32,177,2439,216,1548,38,979,2781
"080","Reggio di Calabria",73,122,1922,22,164,2230,209,1364,41,1073,2687
"080","Reggio di Calabria",74,139,1758,20,195,2112,201,1152,23,1039,2415
"080","Reggio di Calabria",75,114,1665,17,198,1994,203,1182,24,1186,2595
"080","Reggio di Calabria",76,114,1742,12,205,2073,230,1153,25,1152,2560
"080","Reggio di Calabria",77,102,1539,17,227,1885,236,1029,29,1315,2609
"080","Reggio di Calabria",78,112,1585,19,267,1983,209,982,27,1356,2574
"080","Reggio di Calabria",79,91,1395,11,240,1737,230,826,25,1372,2453
"080","Reggio di Calabria",80,91,1313,13,255,1672,238,726,18,1338,2320
"080","Reggio di Calabria",81,75,1232,11,282,1600,206,636,16,1400,2258
"080","Reggio di Calabria",82,61,1007,8,256,1332,220,525,22,1275,2042
"080","Reggio di Calabria",83,76,848,10,273,1207,157,466,12,1185,1820
"080","Reggio di Calabria",84,54,777,9,255,1095,187,421,11,1249,1868
"080","Reggio di Calabria",85,48,664,3,251,966,185,344,12,1136,1677
"080","Reggio di Calabria",86,37,557,5,239,838,166,238,14,1078,1496
"080","Reggio di Calabria",87,31,435,4,232,702,163,203,21,1042,1429
"080","Reggio di Calabria",88,33,394,3,192,622,125,146,16,966,1253
"080","Reggio di Calabria",89,26,285,3,186,500,123,117,14,831,1085
"080","Reggio di Calabria",90,13,180,3,165,361,90,78,6,650,824
"080","Reggio di Calabria",91,13,154,1,142,310,82,55,7,626,770
"080","Reggio di Calabria",92,9,99,2,72,182,56,37,0,343,436
"080","Reggio di Calabria",93,9,54,0,57,120,40,19,2,223,284
"080","Reggio di Calabria",94,5,48,0,45,98,32,20,3,165,220
"080","Reggio di Calabria",95,2,29,0,45,76,48,8,3,202,261
"080","Reggio di Calabria",96,5,30,0,42,77,36,17,1,163,217
"080","Reggio di Calabria",97,4,21,1,41,67,21,12,0,126,159
"080","Reggio di Calabria",98,4,19,0,28,51,13,7,0,88,108
"080","Reggio di Calabria",99,0,8,0,19,27,10,4,0,77,91
"080","Reggio di Calabria",100,2,12,0,27,41,16,4,0,75,95
"081","Trapani",0,1798,0,0,0,1798,1719,0,0,0,1719
"081","Trapani",1,1843,0,0,0,1843,1726,0,0,0,1726
"081","Trapani",2,1949,0,0,0,1949,1851,0,0,0,1851
"081","Trapani",3,1883,0,0,0,1883,1904,0,0,0,1904
"081","Trapani",4,1960,0,0,0,1960,1928,0,0,0,1928
"081","Trapani",5,2030,0,0,0,2030,1915,0,0,0,1915
"081","Trapani",6,2075,0,0,0,2075,1973,0,0,0,1973
"081","Trapani",7,2195,0,0,0,2195,2057,0,0,0,2057
"081","Trapani",8,2214,0,0,0,2214,2066,0,0,0,2066
"081","Trapani",9,2174,0,0,0,2174,2076,0,0,0,2076
"081","Trapani",10,2160,0,0,0,2160,2088,0,0,0,2088
"081","Trapani",11,2284,0,0,0,2284,2126,0,0,0,2126
"081","Trapani",12,2289,0,0,0,2289,2192,0,0,0,2192
"081","Trapani",13,2305,0,0,0,2305,2257,0,0,0,2257
"081","Trapani",14,2381,0,0,0,2381,2183,0,0,0,2183
"081","Trapani",15,2383,0,0,0,2383,2299,0,0,0,2299
"081","Trapani",16,2427,0,0,0,2427,2308,0,0,0,2308
"081","Trapani",17,2523,0,0,0,2523,2436,0,0,0,2436
"081","Trapani",18,2499,0,0,0,2499,2410,4,0,0,2414
"081","Trapani",19,2619,0,0,0,2619,2518,21,0,0,2539
"081","Trapani",20,2649,4,0,0,2653,2367,39,0,0,2406
"081","Trapani",21,2560,18,0,0,2578,2431,90,0,0,2521
"081","Trapani",22,2584,20,0,0,2604,2474,164,4,0,2642
"081","Trapani",23,2567,46,0,0,2613,2405,238,2,1,2646
"081","Trapani",24,2378,78,1,0,2457,2206,312,0,0,2518
"081","Trapani",25,2471,102,1,0,2574,1998,463,3,0,2464
"081","Trapani",26,2390,192,1,0,2583,1893,617,2,5,2517
"081","Trapani",27,2338,264,3,1,2606,1798,807,8,0,2613
"081","Trapani",28,2172,415,1,0,2588,1489,958,10,2,2459
"081","Trapani",29,2106,552,3,0,2661,1320,1258,9,4,2591
"081","Trapani",30,1924,711,1,1,2637,1116,1425,11,9,2561
"081","Trapani",31,1839,879,2,0,2720,1026,1654,13,5,2698
"081","Trapani",32,1556,1152,2,2,2712,863,1797,19,4,2683
"081","Trapani",33,1471,1330,6,0,2807,742,1918,26,11,2697
"081","Trapani",34,1288,1420,6,1,2715,701,2110,20,10,2841
"081","Trapani",35,1201,1714,12,2,2929,650,2205,26,10,2891
"081","Trapani",36,1176,1966,11,1,3154,576,2405,32,10,3023
"081","Trapani",37,1045,2109,19,2,3175,588,2549,57,14,3208
"081","Trapani",38,921,2167,18,2,3108,525,2624,43,17,3209
"081","Trapani",39,796,2159,22,3,2980,433,2597,49,24,3103
"081","Trapani",40,743,2324,29,6,3102,440,2793,65,24,3322
"081","Trapani",41,692,2388,30,4,3114,447,2749,83,34,3313
"081","Trapani",42,668,2644,45,5,3362,422,2874,80,46,3422
"081","Trapani",43,531,2529,35,12,3107,364,2794,79,37,3274
"081","Trapani",44,544,2607,42,16,3209,332,2762,74,47,3215
"081","Trapani",45,457,2542,38,12,3049,378,2739,71,50,3238
"081","Trapani",46,409,2447,51,10,2917,358,2738,96,59,3251
"081","Trapani",47,438,2728,53,14,3233,336,2883,79,80,3378
"081","Trapani",48,351,2650,57,18,3076,320,2697,91,86,3194
"081","Trapani",49,347,2570,61,15,2993,299,2734,89,117,3239
"081","Trapani",50,319,2450,44,12,2825,298,2618,77,106,3099
"081","Trapani",51,313,2529,49,15,2906,278,2619,73,131,3101
"081","Trapani",52,266,2355,50,17,2688,227,2413,67,136,2843
"081","Trapani",53,256,2384,45,19,2704,211,2334,74,170,2789
"081","Trapani",54,216,2297,41,22,2576,223,2377,67,143,2810
"081","Trapani",55,242,2374,48,28,2692,248,2354,82,197,2881
"081","Trapani",56,231,2393,50,28,2702,236,2316,73,201,2826
"081","Trapani",57,211,2388,44,31,2674,230,2257,60,218,2765
"081","Trapani",58,177,2116,40,20,2353,195,2019,75,190,2479
"081","Trapani",59,183,2154,53,38,2428,185,2091,63,260,2599
"081","Trapani",60,185,2241,46,42,2514,171,2114,46,249,2580
"081","Trapani",61,172,2246,35,66,2519,196,2105,61,320,2682
"081","Trapani",62,164,2374,43,56,2637,195,2268,55,381,2899
"081","Trapani",63,153,2394,44,58,2649,207,2218,36,390,2851
"081","Trapani",64,143,2354,24,69,2590,159,2114,43,461,2777
"081","Trapani",65,122,2164,44,83,2413,169,2041,55,483,2748
"081","Trapani",66,116,1885,36,59,2096,142,1582,30,461,2215
"081","Trapani",67,107,1908,30,70,2115,141,1584,41,517,2283
"081","Trapani",68,99,1951,34,101,2185,141,1602,34,555,2332
"081","Trapani",69,100,1851,27,108,2086,146,1555,29,655,2385
"081","Trapani",70,95,1702,23,88,1908,128,1393,24,607,2152
"081","Trapani",71,114,2061,19,126,2320,149,1564,30,825,2568
"081","Trapani",72,83,1973,27,141,2224,147,1503,32,807,2489
"081","Trapani",73,65,1691,11,120,1887,159,1238,20,875,2292
"081","Trapani",74,77,1522,12,164,1775,167,1122,23,896,2208
"081","Trapani",75,66,1532,14,152,1764,148,1019,10,903,2080
"081","Trapani",76,75,1345,14,176,1610,160,919,17,957,2053
"081","Trapani",77,63,1415,11,193,1682,126,833,23,1040,2022
"081","Trapani",78,64,1265,5,180,1514,155,769,16,1067,2007
"081","Trapani",79,44,1123,12,185,1364,145,616,13,1020,1794
"081","Trapani",80,55,1039,10,174,1278,138,541,12,1084,1775
"081","Trapani",81,61,1095,6,236,1398,145,530,13,1258,1946
"081","Trapani",82,35,826,1,217,1079,146,419,12,1127,1704
"081","Trapani",83,26,791,5,192,1014,138,334,10,1122,1604
"081","Trapani",84,37,637,6,193,873,139,275,9,978,1401
"081","Trapani",85,27,574,2,183,786,123,235,11,1047,1416
"081","Trapani",86,26,483,5,202,716,105,189,5,855,1154
"081","Trapani",87,20,396,2,181,599,110,148,4,916,1178
"081","Trapani",88,13,340,2,144,499,78,95,7,770,950
"081","Trapani",89,12,234,1,136,383,64,71,6,680,821
"081","Trapani",90,10,157,3,117,287,48,47,0,539,634
"081","Trapani",91,11,139,2,111,263,60,29,3,515,607
"081","Trapani",92,3,71,1,54,129,25,13,1,273,312
"081","Trapani",93,3,64,0,53,120,16,12,0,207,235
"081","Trapani",94,2,36,0,31,69,17,6,0,170,193
"081","Trapani",95,2,34,0,47,83,15,7,1,171,194
"081","Trapani",96,1,24,0,26,51,11,4,0,141,156
"081","Trapani",97,2,11,0,22,35,3,2,1,113,119
"081","Trapani",98,1,4,0,20,25,9,4,0,65,78
"081","Trapani",99,1,6,0,10,17,2,2,0,57,61
"081","Trapani",100,0,4,0,9,13,7,2,1,62,72
"082","Palermo",0,6233,0,0,0,6233,6000,0,0,0,6000
"082","Palermo",1,6081,0,0,0,6081,5910,0,0,0,5910
"082","Palermo",2,6295,0,0,0,6295,6032,0,0,0,6032
"082","Palermo",3,6376,0,0,0,6376,6039,0,0,0,6039
"082","Palermo",4,6255,0,0,0,6255,6104,0,0,0,6104
"082","Palermo",5,6385,0,0,0,6385,6102,0,0,0,6102
"082","Palermo",6,6531,0,0,0,6531,6262,0,0,0,6262
"082","Palermo",7,6703,0,0,0,6703,6339,0,0,0,6339
"082","Palermo",8,6497,0,0,0,6497,6176,0,0,0,6176
"082","Palermo",9,6506,0,0,0,6506,6250,0,0,0,6250
"082","Palermo",10,6679,0,0,0,6679,6270,0,0,0,6270
"082","Palermo",11,6576,0,0,0,6576,6309,0,0,0,6309
"082","Palermo",12,6705,0,0,0,6705,6348,0,0,0,6348
"082","Palermo",13,6671,0,0,0,6671,6342,0,0,0,6342
"082","Palermo",14,6901,0,0,0,6901,6533,0,0,0,6533
"082","Palermo",15,7001,0,0,0,7001,6734,0,0,0,6734
"082","Palermo",16,7081,0,0,0,7081,6696,1,0,0,6697
"082","Palermo",17,7350,1,0,0,7351,6944,0,0,0,6944
"082","Palermo",18,7674,4,0,0,7678,7343,46,0,0,7389
"082","Palermo",19,8138,22,0,0,8160,7698,167,0,0,7865
"082","Palermo",20,8037,69,0,0,8106,7273,298,0,0,7571
"082","Palermo",21,8001,101,0,0,8102,7222,475,1,0,7698
"082","Palermo",22,8084,214,1,0,8299,7058,728,1,0,7787
"082","Palermo",23,7899,336,1,0,8236,6740,1031,3,2,7776
"082","Palermo",24,7486,513,1,0,8000,6189,1429,1,1,7620
"082","Palermo",25,7136,682,0,0,7818,5771,1835,4,2,7612
"082","Palermo",26,6764,1005,5,1,7775,5411,2276,4,3,7694
"082","Palermo",27,6637,1368,1,0,8006,4893,2886,11,6,7796
"082","Palermo",28,6029,1778,5,1,7813,4346,3465,16,7,7834
"082","Palermo",29,5583,2347,3,2,7935,3975,3948,22,5,7950
"082","Palermo",30,4972,2741,6,1,7720,3483,4387,30,10,7910
"082","Palermo",31,4676,3376,8,0,8060,3087,5087,43,24,8241
"082","Palermo",32,4309,3839,15,5,8168,2804,5442,49,16,8311
"082","Palermo",33,3924,4367,20,4,8315,2554,5860,68,16,8498
"082","Palermo",34,3529,4641,24,7,8201,2331,6262,80,29,8702
"082","Palermo",35,3261,5293,38,5,8597,2159,6668,106,23,8956
"082","Palermo",36,3126,5714,44,11,8895,2114,6885,116,28,9143
"082","Palermo",37,2999,6146,58,5,9208,1929,7264,128,45,9366
"082","Palermo",38,2568,6235,75,13,8891,1809,7065,171,63,9108
"082","Palermo",39,2364,6485,83,10,8942,1706,7400,197,72,9375
"082","Palermo",40,2184,6782,116,11,9093,1689,7496,204,87,9476
"082","Palermo",41,2015,6771,106,12,8904,1563,7498,203,109,9373
"082","Palermo",42,1871,7149,138,22,9180,1505,7820,240,124,9689
"082","Palermo",43,1762,7086,134,20,9002,1550,7653,271,125,9599
"082","Palermo",44,1682,7231,159,35,9107,1483,7672,271,133,9559
"082","Palermo",45,1507,7274,158,28,8967,1381,7819,315,177,9692
"082","Palermo",46,1496,7353,169,33,9051,1393,7828,327,233,9781
"082","Palermo",47,1366,7560,210,35,9171,1315,8038,330,233,9916
"082","Palermo",48,1244,7236,181,60,8721,1287,7618,359,255,9519
"082","Palermo",49,1117,7249,169,63,8598,1216,7686,300,297,9499
"082","Palermo",50,1041,7138,199,48,8426,1170,7410,321,274,9175
"082","Palermo",51,999,6974,184,59,8216,1166,7275,288,306,9035
"082","Palermo",52,936,6826,197,66,8025,1075,6956,312,384,8727
"082","Palermo",53,875,6655,191,80,7801,963,6785,312,411,8471
"082","Palermo",54,858,6684,192,85,7819,1016,6834,292,465,8607
"082","Palermo",55,775,6626,171,91,7663,982,6567,271,534,8354
"082","Palermo",56,714,6499,192,95,7500,893,6414,257,576,8140
"082","Palermo",57,634,6528,192,116,7470,940,6501,259,643,8343
"082","Palermo",58,568,6179,159,122,7028,862,5862,260,658,7642
"082","Palermo",59,572,6217,140,126,7055,803,6080,237,718,7838
"082","Palermo",60,540,6102,137,152,6931,812,5699,249,821,7581
"082","Palermo",61,581,6442,146,144,7313,815,5839,267,902,7823
"082","Palermo",62,477,6130,122,176,6905,783,5909,221,1044,7957
"082","Palermo",63,543,6497,139,195,7374,857,5870,201,1169,8097
"082","Palermo",64,472,6284,141,213,7110,822,5603,214,1330,7969
"082","Palermo",65,406,5917,138,235,6696,733,5141,181,1386,7441
"082","Palermo",66,342,5071,108,226,5747,674,4323,156,1236,6389
"082","Palermo",67,334,4854,97,225,5510,611,4161,143,1459,6374
"082","Palermo",68,286,4355,91,256,4988,584,3725,141,1344,5794
"082","Palermo",69,274,4463,86,280,5103,610,3566,120,1555,5851
"082","Palermo",70,268,4393,70,311,5042,627,3478,125,1744,5974
"082","Palermo",71,312,4599,76,385,5372,674,3779,116,2033,6602
"082","Palermo",72,284,4449,68,367,5168,619,3394,102,2066,6181
"082","Palermo",73,287,4317,67,376,5047,616,3255,110,2253,6234
"082","Palermo",74,243,3747,38,361,4389,569,2800,90,2158,5617
"082","Palermo",75,222,3546,33,411,4212,570,2522,85,2246,5423
"082","Palermo",76,225,3364,43,440,4072,549,2414,73,2475,5511
"082","Palermo",77,220,3120,33,456,3829,544,2245,81,2693,5563
"082","Palermo",78,198,3178,29,543,3948,557,1975,51,2697,5280
"082","Palermo",79,169,2757,30,578,3534,540,1662,53,2673,4928
"082","Palermo",80,184,2599,20,573,3376,524,1503,53,2717,4797
"082","Palermo",81,198,2551,25,566,3340,563,1368,54,2946,4931
"082","Palermo",82,119,1979,14,529,2641,501,976,31,2568,4076
"082","Palermo",83,140,1803,16,552,2511,488,890,39,2600,4017
"082","Palermo",84,105,1510,20,550,2185,426,688,46,2295,3455
"082","Palermo",85,101,1357,13,539,2010,415,563,36,2383,3397
"082","Palermo",86,89,1119,10,494,1712,373,408,30,2071,2882
"082","Palermo",87,76,940,9,490,1515,339,386,21,2134,2880
"082","Palermo",88,67,708,7,413,1195,246,243,13,1742,2244
"082","Palermo",89,49,572,4,339,964,261,202,13,1551,2027
"082","Palermo",90,26,381,5,295,707,184,125,18,1262,1589
"082","Palermo",91,23,307,4,229,563,165,88,7,1110,1370
"082","Palermo",92,16,173,2,147,338,101,40,1,609,751
"082","Palermo",93,18,106,0,110,234,70,24,2,477,573
"082","Palermo",94,9,62,0,84,155,60,16,4,380,460
"082","Palermo",95,13,70,0,90,173,60,27,2,349,438
"082","Palermo",96,9,45,1,83,138,60,16,2,307,385
"082","Palermo",97,9,38,0,67,114,45,9,1,235,290
"082","Palermo",98,3,16,0,44,63,33,17,2,175,227
"082","Palermo",99,2,10,1,23,36,24,5,0,117,146
"082","Palermo",100,5,12,0,32,49,26,5,1,118,150
"083","Messina",0,2645,0,0,0,2645,2579,0,0,0,2579
"083","Messina",1,2776,0,0,0,2776,2714,0,0,0,2714
"083","Messina",2,2731,0,0,0,2731,2668,0,0,0,2668
"083","Messina",3,2843,0,0,0,2843,2789,0,0,0,2789
"083","Messina",4,2868,0,0,0,2868,2751,0,0,0,2751
"083","Messina",5,2956,0,0,0,2956,2695,0,0,0,2695
"083","Messina",6,2900,0,0,0,2900,2678,0,0,0,2678
"083","Messina",7,2898,0,0,0,2898,2802,0,0,0,2802
"083","Messina",8,2941,0,0,0,2941,2825,0,0,0,2825
"083","Messina",9,2918,0,0,0,2918,2794,0,0,0,2794
"083","Messina",10,3110,0,0,0,3110,2842,0,0,0,2842
"083","Messina",11,3075,0,0,0,3075,2883,0,0,0,2883
"083","Messina",12,2976,0,0,0,2976,2983,0,0,0,2983
"083","Messina",13,3058,0,0,0,3058,2882,0,0,0,2882
"083","Messina",14,3137,0,0,0,3137,2937,0,0,0,2937
"083","Messina",15,3288,0,0,0,3288,3047,0,0,0,3047
"083","Messina",16,3378,0,0,0,3378,3085,0,0,0,3085
"083","Messina",17,3462,0,0,0,3462,3269,1,0,0,3270
"083","Messina",18,3663,1,0,0,3664,3460,12,0,0,3472
"083","Messina",19,3810,4,0,0,3814,3615,35,0,0,3650
"083","Messina",20,3875,13,0,0,3888,3601,102,0,0,3703
"083","Messina",21,3997,23,1,0,4021,3733,156,0,0,3889
"083","Messina",22,3881,57,0,0,3938,3691,238,1,0,3930
"083","Messina",23,4008,83,0,0,4091,3600,338,0,1,3939
"083","Messina",24,3951,151,0,1,4103,3387,469,3,1,3860
"083","Messina",25,3800,232,1,0,4033,3200,675,1,1,3877
"083","Messina",26,3683,327,1,0,4011,3002,882,4,2,3890
"083","Messina",27,3508,497,2,0,4007,2884,1098,8,2,3992
"083","Messina",28,3403,629,0,2,4034,2536,1306,12,3,3857
"083","Messina",29,3172,826,3,0,4001,2328,1664,15,1,4008
"083","Messina",30,2946,1032,8,0,3986,2096,1896,14,2,4008
"083","Messina",31,2712,1339,4,2,4057,1925,2099,23,7,4054
"083","Messina",32,2559,1527,11,3,4100,1768,2338,30,5,4141
"083","Messina",33,2334,1816,8,1,4159,1620,2557,35,7,4219
"083","Messina",34,2283,1992,10,2,4287,1525,2741,49,10,4325
"083","Messina",35,2095,2335,20,5,4455,1318,3115,64,26,4523
"083","Messina",36,1968,2577,29,3,4577,1319,3186,67,18,4590
"083","Messina",37,1842,2759,33,3,4637,1234,3534,95,19,4882
"083","Messina",38,1631,2887,32,4,4554,1087,3610,116,30,4843
"083","Messina",39,1576,3033,60,10,4679,1032,3752,121,47,4952
"083","Messina",40,1380,3250,62,6,4698,996,3782,123,48,4949
"083","Messina",41,1288,3197,61,8,4554,934,3702,136,60,4832
"083","Messina",42,1218,3392,63,10,4683,903,3909,143,58,5013
"083","Messina",43,1115,3473,106,13,4707,837,3915,154,75,4981
"083","Messina",44,1119,3635,97,11,4862,808,3989,188,95,5080
"083","Messina",45,1003,3728,100,18,4849,834,4057,187,100,5178
"083","Messina",46,943,3686,113,9,4751,820,4128,184,106,5238
"083","Messina",47,941,3830,119,26,4916,774,4173,174,106,5227
"083","Messina",48,800,3773,114,32,4719,713,3918,160,144,4935
"083","Messina",49,752,3778,112,23,4665,673,4118,180,177,5148
"083","Messina",50,732,3694,115,34,4575,702,3926,182,171,4981
"083","Messina",51,681,3874,130,33,4718,666,3946,181,213,5006
"083","Messina",52,637,3666,116,37,4456,655,3657,179,229,4720
"083","Messina",53,590,3535,104,30,4259,599,3654,164,258,4675
"083","Messina",54,580,3584,110,53,4327,579,3768,165,279,4791
"083","Messina",55,534,3551,94,52,4231,535,3550,150,288,4523
"083","Messina",56,546,3639,104,69,4358,521,3482,169,322,4494
"083","Messina",57,480,3527,98,72,4177,479,3408,159,354,4400
"083","Messina",58,461,3377,99,57,3994,413,3281,129,376,4199
"083","Messina",59,419,3235,85,76,3815,437,3099,128,398,4062
"083","Messina",60,368,3350,105,74,3897,421,3070,138,441,4070
"083","Messina",61,360,3472,96,96,4024,430,3150,126,546,4252
"083","Messina",62,342,3413,81,106,3942,423,3106,101,565,4195
"083","Messina",63,353,3689,89,118,4249,403,3227,113,668,4411
"083","Messina",64,311,3507,115,128,4061,429,3007,128,687,4251
"083","Messina",65,300,3248,79,137,3764,392,2805,103,725,4025
"083","Messina",66,221,2557,64,112,2954,319,2250,86,661,3316
"083","Messina",67,200,2518,57,133,2908,286,2150,75,714,3225
"083","Messina",68,200,2503,58,138,2899,297,2049,60,760,3166
"083","Messina",69,193,2505,39,161,2898,265,2139,84,910,3398
"083","Messina",70,207,2540,43,165,2955,325,2015,79,1012,3431
"083","Messina",71,186,2654,57,215,3112,342,2101,76,1151,3670
"083","Messina",72,182,2566,52,209,3009,313,1861,68,1147,3389
"083","Messina",73,145,2268,35,192,2640,301,1754,63,1215,3333
"083","Messina",74,159,2235,34,217,2645,301,1631,54,1266,3252
"083","Messina",75,148,2092,30,254,2524,362,1542,59,1350,3313
"083","Messina",76,158,2015,34,300,2507,358,1417,41,1429,3245
"083","Messina",77,137,1983,33,279,2432,309,1319,34,1601,3263
"083","Messina",78,143,1907,20,340,2410,327,1309,51,1709,3396
"083","Messina",79,122,1694,27,334,2177,335,1012,34,1582,2963
"083","Messina",80,111,1636,12,357,2116,317,977,43,1604,2941
"083","Messina",81,110,1534,17,372,2033,352,900,29,1867,3148
"083","Messina",82,83,1182,20,365,1650,326,726,26,1613,2691
"083","Messina",83,79,1124,8,315,1526,312,561,31,1623,2527
"083","Messina",84,64,982,12,337,1395,288,425,22,1501,2236
"083","Messina",85,69,815,10,320,1214,264,382,27,1515,2188
"083","Messina",86,52,658,5,278,993,273,328,18,1434,2053
"083","Messina",87,43,596,7,301,947,237,272,16,1438,1963
"083","Messina",88,47,406,1,280,734,198,194,11,1109,1512
"083","Messina",89,43,363,4,232,642,188,143,14,1106,1451
"083","Messina",90,28,302,2,179,511,122,89,7,870,1088
"083","Messina",91,25,190,1,209,425,136,61,18,765,980
"083","Messina",92,7,109,2,88,206,73,39,3,459,574
"083","Messina",93,4,63,1,60,128,38,17,4,265,324
"083","Messina",94,8,49,0,58,115,49,17,1,245,312
"083","Messina",95,5,49,0,58,112,35,11,3,226,275
"083","Messina",96,6,46,2,45,99,32,17,3,221,273
"083","Messina",97,3,21,1,34,59,26,12,1,163,202
"083","Messina",98,3,24,0,16,43,14,13,0,108,135
"083","Messina",99,3,8,0,11,22,5,13,0,68,86
"083","Messina",100,4,18,0,19,41,15,19,1,114,149
"084","Agrigento",0,1957,0,0,0,1957,1958,0,0,0,1958
"084","Agrigento",1,2052,0,0,0,2052,1931,0,0,0,1931
"084","Agrigento",2,2107,0,0,0,2107,2008,0,0,0,2008
"084","Agrigento",3,2162,0,0,0,2162,1980,0,0,0,1980
"084","Agrigento",4,2189,0,0,0,2189,2045,0,0,0,2045
"084","Agrigento",5,2176,0,0,0,2176,2090,0,0,0,2090
"084","Agrigento",6,2310,0,0,0,2310,2197,0,0,0,2197
"084","Agrigento",7,2361,0,0,0,2361,2221,0,0,0,2221
"084","Agrigento",8,2225,0,0,0,2225,2212,0,0,0,2212
"084","Agrigento",9,2367,0,0,0,2367,2281,0,0,0,2281
"084","Agrigento",10,2401,0,0,0,2401,2292,0,0,0,2292
"084","Agrigento",11,2455,0,0,0,2455,2344,0,0,0,2344
"084","Agrigento",12,2409,0,0,0,2409,2495,0,0,0,2495
"084","Agrigento",13,2556,0,0,0,2556,2440,0,0,0,2440
"084","Agrigento",14,2548,0,0,0,2548,2370,0,0,0,2370
"084","Agrigento",15,2610,0,0,0,2610,2402,0,0,0,2402
"084","Agrigento",16,2542,0,0,0,2542,2411,0,0,0,2411
"084","Agrigento",17,2664,0,0,0,2664,2472,0,0,0,2472
"084","Agrigento",18,2761,1,0,0,2762,2506,20,0,0,2526
"084","Agrigento",19,2854,8,0,0,2862,2791,57,0,0,2848
"084","Agrigento",20,2795,13,0,0,2808,2639,110,0,2,2751
"084","Agrigento",21,2938,19,0,0,2957,2671,170,0,0,2841
"084","Agrigento",22,2847,41,0,0,2888,2464,257,1,1,2723
"084","Agrigento",23,2898,115,1,0,3014,2431,371,1,1,2804
"084","Agrigento",24,2688,149,0,0,2837,2189,519,1,0,2709
"084","Agrigento",25,2634,210,0,0,2844,2035,718,1,1,2755
"084","Agrigento",26,2470,270,0,0,2740,1914,834,2,3,2753
"084","Agrigento",27,2374,411,0,0,2785,1741,1031,3,2,2777
"084","Agrigento",28,2154,578,1,0,2733,1425,1259,8,4,2696
"084","Agrigento",29,1991,687,2,0,2680,1287,1413,10,3,2713
"084","Agrigento",30,1929,945,2,0,2876,1140,1652,9,8,2809
"084","Agrigento",31,1727,1144,2,0,2873,1030,1793,16,6,2845
"084","Agrigento",32,1550,1330,10,1,2891,855,1942,19,7,2823
"084","Agrigento",33,1352,1477,2,2,2833,701,2091,20,13,2825
"084","Agrigento",34,1277,1659,9,2,2947,703,2216,16,11,2946
"084","Agrigento",35,1188,1944,11,2,3145,691,2263,25,19,2998
"084","Agrigento",36,1120,1986,16,1,3123,632,2536,36,19,3223
"084","Agrigento",37,986,2079,21,4,3090,632,2608,35,26,3301
"084","Agrigento",38,870,2170,16,5,3061,596,2609,41,27,3273
"084","Agrigento",39,867,2168,19,2,3056,509,2569,41,30,3149
"084","Agrigento",40,750,2410,32,6,3198,490,2782,53,38,3363
"084","Agrigento",41,733,2418,38,4,3193,489,2840,49,43,3421
"084","Agrigento",42,699,2659,38,5,3401,514,2845,46,44,3449
"084","Agrigento",43,632,2594,42,5,3273,486,2858,66,64,3474
"084","Agrigento",44,563,2728,37,8,3336,484,3008,78,58,3628
"084","Agrigento",45,541,2612,41,10,3204,477,2845,54,68,3444
"084","Agrigento",46,473,2699,47,11,3230,451,2834,78,78,3441
"084","Agrigento",47,479,2838,50,13,3380,439,2956,55,87,3537
"084","Agrigento",48,410,2548,40,19,3017,397,2670,54,94,3215
"084","Agrigento",49,376,2506,33,13,2928,382,2588,57,109,3136
"084","Agrigento",50,392,2520,49,17,2978,341,2574,61,138,3114
"084","Agrigento",51,341,2571,51,24,2987,385,2712,71,141,3309
"084","Agrigento",52,310,2447,40,17,2814,330,2511,64,156,3061
"084","Agrigento",53,322,2314,45,21,2702,320,2371,51,158,2900
"084","Agrigento",54,293,2490,29,16,2828,290,2441,44,178,2953
"084","Agrigento",55,280,2325,36,19,2660,291,2407,52,208,2958
"084","Agrigento",56,243,2304,37,31,2615,300,2375,44,231,2950
"084","Agrigento",57,226,2380,36,38,2680,275,2261,46,247,2829
"084","Agrigento",58,206,2082,46,36,2370,232,2067,43,269,2611
"084","Agrigento",59,195,2139,27,38,2399,197,2052,47,300,2596
"084","Agrigento",60,155,2103,29,48,2335,231,2084,47,300,2662
"084","Agrigento",61,162,2159,35,50,2406,234,2047,39,352,2672
"084","Agrigento",62,181,2350,39,48,2618,236,2123,32,438,2829
"084","Agrigento",63,163,2270,37,55,2525,226,2073,40,445,2784
"084","Agrigento",64,157,2336,29,63,2585,229,2138,41,531,2939
"084","Agrigento",65,169,2069,22,74,2334,185,1794,28,573,2580
"084","Agrigento",66,103,1894,15,70,2082,163,1577,22,500,2262
"084","Agrigento",67,116,1810,21,68,2015,173,1528,21,513,2235
"084","Agrigento",68,108,1659,26,94,1887,171,1330,18,565,2084
"084","Agrigento",69,91,1552,16,67,1726,157,1317,22,563,2059
"084","Agrigento",70,86,1593,16,82,1777,186,1284,23,655,2148
"084","Agrigento",71,124,1897,24,119,2164,194,1477,20,789,2480
"084","Agrigento",72,86,1894,22,116,2118,204,1396,17,898,2515
"084","Agrigento",73,78,1742,16,144,1980,218,1339,14,914,2485
"084","Agrigento",74,99,1636,17,137,1889,199,1143,16,921,2279
"084","Agrigento",75,77,1422,11,153,1663,172,1005,13,987,2177
"084","Agrigento",76,70,1516,17,169,1772,200,936,11,1066,2213
"084","Agrigento",77,68,1426,13,194,1701,197,910,13,1112,2232
"084","Agrigento",78,53,1347,9,202,1611,174,767,14,1126,2081
"084","Agrigento",79,52,1161,6,185,1404,182,683,14,1141,2020
"084","Agrigento",80,54,1126,10,235,1425,184,612,8,1165,1969
"084","Agrigento",81,49,1091,8,241,1389,209,536,13,1284,2042
"084","Agrigento",82,44,884,4,215,1147,169,422,16,1077,1684
"084","Agrigento",83,37,801,4,228,1070,175,321,7,1094,1597
"084","Agrigento",84,39,739,0,228,1006,166,299,6,1089,1560
"084","Agrigento",85,24,647,3,238,912,135,233,7,997,1372
"084","Agrigento",86,32,500,3,209,744,120,161,9,879,1169
"084","Agrigento",87,26,424,2,195,647,105,122,7,828,1062
"084","Agrigento",88,21,327,2,164,514,96,81,5,676,858
"084","Agrigento",89,16,250,0,127,393,77,51,3,610,741
"084","Agrigento",90,13,166,2,101,282,46,36,4,432,518
"084","Agrigento",91,9,133,0,97,239,42,27,1,388,458
"084","Agrigento",92,6,69,1,44,120,29,12,0,233,274
"084","Agrigento",93,6,49,0,43,98,18,3,0,170,191
"084","Agrigento",94,1,32,1,35,69,11,7,1,122,141
"084","Agrigento",95,2,37,0,27,66,17,5,1,136,159
"084","Agrigento",96,1,31,0,32,64,11,4,1,101,117
"084","Agrigento",97,1,23,0,25,49,9,6,0,70,85
"084","Agrigento",98,4,12,1,18,35,6,2,1,57,66
"084","Agrigento",99,0,8,0,8,16,3,0,0,42,45
"084","Agrigento",100,0,3,0,16,19,5,1,1,58,65
"085","Caltanissetta",0,1196,0,0,0,1196,1136,0,0,0,1136
"085","Caltanissetta",1,1286,0,0,0,1286,1202,0,0,0,1202
"085","Caltanissetta",2,1308,0,0,0,1308,1303,0,0,0,1303
"085","Caltanissetta",3,1391,0,0,0,1391,1271,0,0,0,1271
"085","Caltanissetta",4,1335,0,0,0,1335,1247,0,0,0,1247
"085","Caltanissetta",5,1491,0,0,0,1491,1323,0,0,0,1323
"085","Caltanissetta",6,1493,0,0,0,1493,1410,0,0,0,1410
"085","Caltanissetta",7,1522,0,0,0,1522,1468,0,0,0,1468
"085","Caltanissetta",8,1471,0,0,0,1471,1426,0,0,0,1426
"085","Caltanissetta",9,1513,0,0,0,1513,1388,0,0,0,1388
"085","Caltanissetta",10,1587,0,0,0,1587,1450,0,0,0,1450
"085","Caltanissetta",11,1486,0,0,0,1486,1443,0,0,0,1443
"085","Caltanissetta",12,1533,0,0,0,1533,1552,0,0,0,1552
"085","Caltanissetta",13,1632,0,0,0,1632,1481,0,0,0,1481
"085","Caltanissetta",14,1577,0,0,0,1577,1551,0,0,0,1551
"085","Caltanissetta",15,1627,0,0,0,1627,1518,0,0,0,1518
"085","Caltanissetta",16,1719,0,0,0,1719,1569,0,0,0,1569
"085","Caltanissetta",17,1732,0,0,0,1732,1605,0,0,0,1605
"085","Caltanissetta",18,1801,1,0,0,1802,1757,15,0,0,1772
"085","Caltanissetta",19,1852,8,0,0,1860,1768,37,0,0,1805
"085","Caltanissetta",20,1911,7,0,0,1918,1742,75,0,0,1817
"085","Caltanissetta",21,1813,19,0,0,1832,1646,140,2,1,1789
"085","Caltanissetta",22,1811,44,1,0,1856,1483,209,1,1,1694
"085","Caltanissetta",23,1717,92,2,0,1811,1534,271,2,0,1807
"085","Caltanissetta",24,1626,109,1,0,1736,1414,359,0,0,1773
"085","Caltanissetta",25,1526,186,3,0,1715,1240,487,2,0,1729
"085","Caltanissetta",26,1489,264,3,1,1757,1137,579,5,3,1724
"085","Caltanissetta",27,1345,332,3,0,1680,972,707,6,2,1687
"085","Caltanissetta",28,1203,485,3,0,1691,923,816,14,3,1756
"085","Caltanissetta",29,1129,519,4,0,1652,739,906,10,2,1657
"085","Caltanissetta",30,1062,636,6,0,1704,701,1041,12,2,1756
"085","Caltanissetta",31,959,738,5,0,1702,600,1132,13,5,1750
"085","Caltanissetta",32,906,779,9,1,1695,538,1227,18,8,1791
"085","Caltanissetta",33,767,930,7,0,1704,407,1300,24,8,1739
"085","Caltanissetta",34,730,1068,11,1,1810,406,1285,23,10,1724
"085","Caltanissetta",35,650,1188,22,1,1861,377,1383,28,10,1798
"085","Caltanissetta",36,626,1267,14,4,1911,370,1493,33,13,1909
"085","Caltanissetta",37,562,1288,24,1,1875,325,1580,40,10,1955
"085","Caltanissetta",38,487,1353,15,2,1857,322,1624,38,15,1999
"085","Caltanissetta",39,473,1401,24,2,1900,287,1627,34,27,1975
"085","Caltanissetta",40,419,1439,30,2,1890,279,1657,36,18,1990
"085","Caltanissetta",41,368,1462,14,6,1850,296,1682,63,33,2074
"085","Caltanissetta",42,377,1527,25,2,1931,281,1710,49,21,2061
"085","Caltanissetta",43,352,1546,38,8,1944,264,1713,55,41,2073
"085","Caltanissetta",44,307,1688,33,5,2033,265,1745,46,38,2094
"085","Caltanissetta",45,315,1646,28,5,1994,248,1762,57,45,2112
"085","Caltanissetta",46,285,1664,43,8,2000,294,1794,51,47,2186
"085","Caltanissetta",47,258,1679,41,6,1984,264,1844,73,72,2253
"085","Caltanissetta",48,249,1661,34,12,1956,252,1625,54,53,1984
"085","Caltanissetta",49,197,1570,40,9,1816,220,1747,62,84,2113
"085","Caltanissetta",50,174,1566,30,10,1780,236,1608,45,81,1970
"085","Caltanissetta",51,198,1677,33,11,1919,217,1664,41,96,2018
"085","Caltanissetta",52,148,1535,28,15,1726,189,1583,64,97,1933
"085","Caltanissetta",53,171,1454,35,27,1687,186,1525,54,116,1881
"085","Caltanissetta",54,141,1408,35,20,1604,180,1466,53,124,1823
"085","Caltanissetta",55,120,1402,32,18,1572,157,1467,38,124,1786
"085","Caltanissetta",56,122,1511,34,26,1693,137,1422,44,137,1740
"085","Caltanissetta",57,112,1435,28,27,1602,146,1413,40,169,1768
"085","Caltanissetta",58,91,1235,29,18,1373,143,1256,29,167,1595
"085","Caltanissetta",59,86,1200,26,16,1328,138,1260,24,183,1605
"085","Caltanissetta",60,94,1294,23,27,1438,153,1213,31,196,1593
"085","Caltanissetta",61,84,1298,21,26,1429,152,1228,31,203,1614
"085","Caltanissetta",62,101,1419,25,28,1573,154,1272,31,269,1726
"085","Caltanissetta",63,77,1394,17,39,1527,156,1301,35,287,1779
"085","Caltanissetta",64,103,1392,19,38,1552,136,1253,19,327,1735
"085","Caltanissetta",65,78,1262,16,51,1407,118,1058,19,350,1545
"085","Caltanissetta",66,74,1067,15,54,1210,123,979,7,351,1460
"085","Caltanissetta",67,56,1055,14,54,1179,106,853,15,332,1306
"085","Caltanissetta",68,66,1014,15,47,1142,107,816,10,394,1327
"085","Caltanissetta",69,58,957,14,45,1074,96,740,10,380,1226
"085","Caltanissetta",70,55,950,9,64,1078,124,782,16,441,1363
"085","Caltanissetta",71,58,1127,12,79,1276,126,855,16,499,1496
"085","Caltanissetta",72,58,1045,9,72,1184,124,781,13,528,1446
"085","Caltanissetta",73,65,1081,8,78,1232,115,790,13,642,1560
"085","Caltanissetta",74,49,891,9,88,1037,107,563,8,521,1199
"085","Caltanissetta",75,35,876,12,98,1021,114,554,10,635,1313
"085","Caltanissetta",76,40,852,10,116,1018,113,512,9,620,1254
"085","Caltanissetta",77,44,852,6,98,1000,97,489,7,655,1248
"085","Caltanissetta",78,44,755,7,130,936,121,412,11,710,1254
"085","Caltanissetta",79,40,633,6,120,799,122,350,8,691,1171
"085","Caltanissetta",80,25,626,4,132,787,118,344,5,676,1143
"085","Caltanissetta",81,26,641,5,125,797,119,251,9,719,1098
"085","Caltanissetta",82,33,472,6,120,631,98,192,5,651,946
"085","Caltanissetta",83,24,417,4,129,574,91,174,11,646,922
"085","Caltanissetta",84,12,340,9,146,507,84,117,4,587,792
"085","Caltanissetta",85,14,333,0,126,473,91,115,2,595,803
"085","Caltanissetta",86,20,253,3,106,382,73,74,1,474,622
"085","Caltanissetta",87,12,223,0,112,347,54,56,4,450,564
"085","Caltanissetta",88,7,175,0,90,272,65,37,2,364,468
"085","Caltanissetta",89,6,132,0,89,227,50,33,2,320,405
"085","Caltanissetta",90,1,68,0,60,129,35,18,2,245,300
"085","Caltanissetta",91,3,64,1,51,119,36,6,2,226,270
"085","Caltanissetta",92,6,43,1,41,91,15,6,1,123,145
"085","Caltanissetta",93,3,30,1,26,60,8,1,2,87,98
"085","Caltanissetta",94,3,22,0,19,44,6,4,0,61,71
"085","Caltanissetta",95,0,11,0,22,33,11,2,0,64,77
"085","Caltanissetta",96,0,10,0,16,26,4,1,0,44,49
"085","Caltanissetta",97,2,5,0,16,23,3,1,0,35,39
"085","Caltanissetta",98,0,6,0,10,16,1,1,0,36,38
"085","Caltanissetta",99,0,5,0,5,10,7,0,0,21,28
"085","Caltanissetta",100,1,3,0,3,7,2,1,0,25,28
"086","Enna",0,743,0,0,0,743,704,0,0,0,704
"086","Enna",1,723,0,0,0,723,742,0,0,0,742
"086","Enna",2,828,0,0,0,828,709,0,0,0,709
"086","Enna",3,796,0,0,0,796,756,0,0,0,756
"086","Enna",4,800,0,0,0,800,757,0,0,0,757
"086","Enna",5,852,0,0,0,852,757,0,0,0,757
"086","Enna",6,816,0,0,0,816,806,0,0,0,806
"086","Enna",7,808,0,0,0,808,790,0,0,0,790
"086","Enna",8,875,0,0,0,875,774,0,0,0,774
"086","Enna",9,858,0,0,0,858,851,0,0,0,851
"086","Enna",10,893,0,0,0,893,921,0,0,0,921
"086","Enna",11,912,0,0,0,912,925,0,0,0,925
"086","Enna",12,957,0,0,0,957,901,0,0,0,901
"086","Enna",13,955,0,0,0,955,883,0,0,0,883
"086","Enna",14,948,0,0,0,948,881,0,0,0,881
"086","Enna",15,971,0,0,0,971,897,0,0,0,897
"086","Enna",16,988,0,0,0,988,973,0,0,0,973
"086","Enna",17,1046,0,0,0,1046,1001,0,0,0,1001
"086","Enna",18,1129,0,0,0,1129,986,5,0,0,991
"086","Enna",19,1088,1,0,0,1089,1044,17,0,0,1061
"086","Enna",20,1109,4,0,0,1113,1053,40,1,0,1094
"086","Enna",21,1049,5,0,0,1054,1014,67,1,0,1082
"086","Enna",22,1126,24,0,0,1150,964,85,0,0,1049
"086","Enna",23,1080,31,1,0,1112,933,162,3,0,1098
"086","Enna",24,992,64,1,0,1057,921,194,0,0,1115
"086","Enna",25,1026,109,0,0,1135,853,229,4,0,1086
"086","Enna",26,942,126,2,0,1070,827,305,1,0,1133
"086","Enna",27,969,181,2,0,1152,697,389,5,0,1091
"086","Enna",28,874,198,1,0,1073,616,423,6,0,1045
"086","Enna",29,799,258,0,0,1057,555,517,2,1,1075
"086","Enna",30,729,331,2,1,1063,467,554,6,2,1029
"086","Enna",31,710,380,4,0,1094,444,605,8,1,1058
"086","Enna",32,586,487,4,0,1077,349,696,5,4,1054
"086","Enna",33,524,522,4,0,1050,334,714,11,2,1061
"086","Enna",34,448,584,4,0,1036,317,794,11,6,1128
"086","Enna",35,467,651,7,0,1125,314,890,14,2,1220
"086","Enna",36,403,727,11,0,1141,262,914,18,5,1199
"086","Enna",37,414,782,6,4,1206,240,912,18,6,1176
"086","Enna",38,345,783,18,3,1149,223,920,19,9,1171
"086","Enna",39,337,847,14,1,1199,260,980,33,11,1284
"086","Enna",40,298,899,7,2,1206,197,1009,21,12,1239
"086","Enna",41,292,882,17,4,1195,197,1052,25,14,1288
"086","Enna",42,241,1000,24,4,1269,171,1102,23,16,1312
"086","Enna",43,248,1003,20,6,1277,171,1160,25,21,1377
"086","Enna",44,234,1019,14,1,1268,147,1073,40,23,1283
"086","Enna",45,227,1058,27,3,1315,195,1039,25,19,1278
"086","Enna",46,196,1034,28,4,1262,172,1036,34,32,1274
"086","Enna",47,188,1091,16,7,1302,180,1104,32,44,1360
"086","Enna",48,154,992,15,2,1163,177,1049,27,41,1294
"086","Enna",49,148,1041,21,9,1219,138,1019,34,46,1237
"086","Enna",50,151,987,24,3,1165,133,1062,32,49,1276
"086","Enna",51,135,1010,27,4,1176,176,1069,28,57,1330
"086","Enna",52,126,1010,19,6,1161,134,998,31,55,1218
"086","Enna",53,97,947,15,8,1067,131,970,31,59,1191
"086","Enna",54,96,883,15,10,1004,141,976,31,70,1218
"086","Enna",55,93,946,21,12,1072,123,919,30,77,1149
"086","Enna",56,100,955,19,10,1084,138,910,31,89,1168
"086","Enna",57,89,941,18,8,1056,142,956,25,82,1205
"086","Enna",58,86,885,13,14,998,132,815,27,105,1079
"086","Enna",59,83,855,21,19,978,127,846,21,103,1097
"086","Enna",60,62,862,16,21,961,112,864,14,110,1100
"086","Enna",61,81,858,24,19,982,137,876,25,132,1170
"086","Enna",62,89,900,18,30,1037,110,888,20,163,1181
"086","Enna",63,67,948,18,29,1062,108,826,20,193,1147
"086","Enna",64,64,891,16,30,1001,99,796,21,170,1086
"086","Enna",65,65,765,7,32,869,77,673,9,189,948
"086","Enna",66,47,644,12,24,727,82,611,6,191,890
"086","Enna",67,66,612,8,25,711,73,524,8,187,792
"086","Enna",68,33,572,6,30,641,71,544,6,195,816
"086","Enna",69,39,577,6,27,649,44,491,18,201,754
"086","Enna",70,46,582,9,30,667,63,562,6,222,853
"086","Enna",71,60,747,7,66,880,92,624,11,310,1037
"086","Enna",72,45,722,8,45,820,76,619,13,366,1074
"086","Enna",73,58,736,12,70,876,88,587,3,346,1024
"086","Enna",74,37,635,12,72,756,89,442,6,385,922
"086","Enna",75,31,634,5,68,738,67,409,7,354,837
"086","Enna",76,39,570,7,79,695,82,379,5,412,878
"086","Enna",77,40,599,4,70,713,75,351,12,524,962
"086","Enna",78,36,515,8,77,636,78,323,5,449,855
"086","Enna",79,28,463,2,69,562,80,276,12,420,788
"086","Enna",80,31,387,4,79,501,73,249,4,448,774
"086","Enna",81,24,446,7,99,576,72,242,6,518,838
"086","Enna",82,22,360,5,88,475,79,201,6,454,740
"086","Enna",83,19,324,5,95,443,71,145,8,457,681
"086","Enna",84,39,235,15,110,399,55,113,2,420,590
"086","Enna",85,11,237,4,92,344,57,106,2,409,574
"086","Enna",86,15,178,1,91,285,56,61,5,390,512
"086","Enna",87,15,144,3,80,242,39,61,5,307,412
"086","Enna",88,10,134,2,75,221,41,31,0,269,341
"086","Enna",89,9,85,1,72,167,30,31,2,265,328
"086","Enna",90,4,86,0,49,139,25,18,1,193,237
"086","Enna",91,5,46,0,40,91,34,12,0,169,215
"086","Enna",92,1,32,2,30,65,6,7,2,113,128
"086","Enna",93,2,15,0,13,30,6,0,0,51,57
"086","Enna",94,1,10,0,11,22,7,1,0,52,60
"086","Enna",95,2,10,0,17,29,2,3,0,41,46
"086","Enna",96,1,6,0,10,17,4,1,0,36,41
"086","Enna",97,0,5,0,12,17,2,1,0,26,29
"086","Enna",98,0,2,0,7,9,2,0,0,23,25
"086","Enna",99,0,5,0,5,10,1,0,0,5,6
"086","Enna",100,1,1,0,4,6,1,0,0,19,20
"087","Catania",0,5230,0,0,0,5230,5329,0,0,0,5329
"087","Catania",1,5357,0,0,0,5357,5122,0,0,0,5122
"087","Catania",2,5441,0,0,0,5441,5144,0,0,0,5144
"087","Catania",3,5694,0,0,0,5694,5312,0,0,0,5312
"087","Catania",4,5516,0,0,0,5516,5396,0,0,0,5396
"087","Catania",5,5735,0,0,0,5735,5220,0,0,0,5220
"087","Catania",6,5827,0,0,0,5827,5478,0,0,0,5478
"087","Catania",7,5981,0,0,0,5981,5526,0,0,0,5526
"087","Catania",8,5849,0,0,0,5849,5636,0,0,0,5636
"087","Catania",9,5779,0,0,0,5779,5563,0,0,0,5563
"087","Catania",10,5781,0,0,0,5781,5496,0,0,0,5496
"087","Catania",11,5973,0,0,0,5973,5571,0,0,0,5571
"087","Catania",12,5901,0,0,0,5901,5658,0,0,0,5658
"087","Catania",13,5868,0,0,0,5868,5769,0,0,0,5769
"087","Catania",14,6011,0,0,0,6011,5766,0,0,0,5766
"087","Catania",15,6136,0,0,0,6136,5828,0,0,0,5828
"087","Catania",16,6147,0,0,0,6147,5953,0,0,0,5953
"087","Catania",17,6419,0,0,0,6419,6272,1,0,0,6273
"087","Catania",18,6729,5,0,0,6734,6462,52,0,0,6514
"087","Catania",19,7208,13,0,0,7221,6620,135,0,0,6755
"087","Catania",20,7064,51,0,0,7115,6560,286,0,0,6846
"087","Catania",21,7104,107,1,0,7212,6502,418,0,0,6920
"087","Catania",22,6896,202,0,0,7098,6334,652,0,0,6986
"087","Catania",23,6842,284,2,0,7128,6050,899,2,3,6954
"087","Catania",24,6567,466,3,0,7036,5718,1205,5,3,6931
"087","Catania",25,6319,678,0,1,6998,5088,1538,7,2,6635
"087","Catania",26,6100,872,6,0,6978,4991,1968,7,5,6971
"087","Catania",27,5823,1235,3,0,7061,4565,2497,13,4,7079
"087","Catania",28,5256,1573,7,1,6837,4006,2750,16,9,6781
"087","Catania",29,5127,1968,8,0,7103,3721,3337,25,11,7094
"087","Catania",30,4486,2310,5,1,6802,3294,3729,25,17,7065
"087","Catania",31,4190,2776,16,1,6983,2881,4230,45,12,7168
"087","Catania",32,3821,3245,13,2,7081,2559,4606,54,12,7231
"087","Catania",33,3729,3636,22,6,7393,2453,5067,44,22,7586
"087","Catania",34,3346,4034,28,2,7410,2266,5163,85,31,7545
"087","Catania",35,3150,4436,38,5,7629,2118,5690,105,32,7945
"087","Catania",36,2845,4760,43,9,7657,1926,5913,99,42,7980
"087","Catania",37,2755,5261,54,10,8080,1916,6233,124,43,8316
"087","Catania",38,2418,5155,74,12,7659,1647,6268,159,64,8138
"087","Catania",39,2256,5579,94,9,7938,1553,6205,145,74,7977
"087","Catania",40,2059,5752,89,15,7915,1558,6570,159,70,8357
"087","Catania",41,1771,5820,82,16,7689,1436,6578,194,83,8291
"087","Catania",42,1753,6011,98,13,7875,1352,6819,212,116,8499
"087","Catania",43,1592,6168,124,21,7905,1354,6664,212,113,8343
"087","Catania",44,1520,6253,138,26,7937,1218,6896,249,148,8511
"087","Catania",45,1471,6254,139,34,7898,1187,6894,233,158,8472
"087","Catania",46,1288,6226,148,38,7700,1134,6797,245,187,8363
"087","Catania",47,1227,6592,152,23,7994,1148,6951,256,215,8570
"087","Catania",48,1120,6246,158,34,7558,981,6614,238,224,8057
"087","Catania",49,964,6421,164,31,7580,1040,6597,252,262,8151
"087","Catania",50,947,6246,166,51,7410,965,6635,280,283,8163
"087","Catania",51,869,6184,162,45,7260,905,6634,247,340,8126
"087","Catania",52,864,5960,160,53,7037,847,6124,278,365,7614
"087","Catania",53,721,5888,148,67,6824,782,6041,258,406,7487
"087","Catania",54,709,5915,143,69,6836,811,5990,268,445,7514
"087","Catania",55,653,5742,135,74,6604,727,5962,251,476,7416
"087","Catania",56,573,5931,158,84,6746,713,5852,222,515,7302
"087","Catania",57,552,5697,123,96,6468,681,5760,250,586,7277
"087","Catania",58,509,5519,120,94,6242,586,5275,245,637,6743
"087","Catania",59,481,5295,123,97,5996,609,5043,215,672,6539
"087","Catania",60,431,5239,115,137,5922,603,4878,168,702,6351
"087","Catania",61,422,5381,108,148,6059,613,4983,241,784,6621
"087","Catania",62,442,5189,116,142,5889,561,4755,191,890,6397
"087","Catania",63,423,5603,104,172,6302,544,5054,178,1034,6810
"087","Catania",64,373,5394,109,180,6056,526,4947,193,1111,6777
"087","Catania",65,342,4971,107,197,5617,513,4488,160,1145,6306
"087","Catania",66,282,4126,85,181,4674,452,3509,121,1063,5145
"087","Catania",67,285,3829,76,186,4376,446,3368,135,1076,5025
"087","Catania",68,221,3615,80,212,4128,439,3057,120,1203,4819
"087","Catania",69,238,3550,73,196,4057,414,2921,103,1339,4777
"087","Catania",70,184,3575,63,207,4029,383,2830,116,1303,4632
"087","Catania",71,221,3960,65,290,4536,440,3183,146,1788,5557
"087","Catania",72,232,3746,59,317,4354,415,2982,110,1843,5350
"087","Catania",73,227,3609,61,337,4234,409,2712,105,1889,5115
"087","Catania",74,178,3143,42,288,3651,370,2339,99,1807,4615
"087","Catania",75,177,3022,40,353,3592,360,2084,79,1945,4468
"087","Catania",76,197,3030,48,357,3632,380,2047,95,2204,4726
"087","Catania",77,169,3015,40,414,3638,389,1942,77,2388,4796
"087","Catania",78,154,2839,38,465,3496,408,1692,61,2418,4579
"087","Catania",79,140,2385,25,451,3001,366,1365,70,2220,4021
"087","Catania",80,137,2165,21,433,2756,374,1217,59,2356,4006
"087","Catania",81,144,2202,37,491,2874,380,1156,75,2593,4204
"087","Catania",82,107,1739,21,487,2354,329,851,55,2336,3571
"087","Catania",83,101,1557,16,417,2091,324,740,53,2158,3275
"087","Catania",84,103,1327,13,430,1873,314,566,40,2085,3005
"087","Catania",85,62,1012,16,423,1513,306,424,34,1980,2744
"087","Catania",86,63,923,16,385,1387,278,358,35,1741,2412
"087","Catania",87,54,752,7,387,1200,248,254,26,1640,2168
"087","Catania",88,53,571,12,330,966,202,185,20,1475,1882
"087","Catania",89,31,437,10,265,743,159,143,8,1338,1648
"087","Catania",90,32,354,6,233,625,145,74,14,1077,1310
"087","Catania",91,18,251,1,208,478,126,59,12,860,1057
"087","Catania",92,14,134,0,102,250,64,35,3,467,569
"087","Catania",93,9,77,2,77,165,44,26,5,313,388
"087","Catania",94,6,72,5,77,160,34,17,4,248,303
"087","Catania",95,9,62,2,72,145,33,11,7,235,286
"087","Catania",96,6,35,1,45,87,27,5,0,205,237
"087","Catania",97,3,20,1,32,56,21,7,2,177,207
"087","Catania",98,3,14,1,20,38,15,3,1,96,115
"087","Catania",99,4,10,0,10,24,12,5,1,65,83
"087","Catania",100,2,6,1,17,26,16,1,0,93,110
"088","Ragusa",0,1536,0,0,0,1536,1436,0,0,0,1436
"088","Ragusa",1,1532,0,0,0,1532,1419,0,0,0,1419
"088","Ragusa",2,1552,0,0,0,1552,1554,0,0,0,1554
"088","Ragusa",3,1570,0,0,0,1570,1537,0,0,0,1537
"088","Ragusa",4,1523,0,0,0,1523,1475,0,0,0,1475
"088","Ragusa",5,1656,0,0,0,1656,1481,0,0,0,1481
"088","Ragusa",6,1633,0,0,0,1633,1455,0,0,0,1455
"088","Ragusa",7,1554,0,0,0,1554,1511,0,0,0,1511
"088","Ragusa",8,1633,0,0,0,1633,1522,0,0,0,1522
"088","Ragusa",9,1612,0,0,0,1612,1547,0,0,0,1547
"088","Ragusa",10,1615,0,0,0,1615,1574,0,0,0,1574
"088","Ragusa",11,1666,0,0,0,1666,1527,0,0,0,1527
"088","Ragusa",12,1685,0,0,0,1685,1560,0,0,0,1560
"088","Ragusa",13,1638,0,0,0,1638,1553,0,0,0,1553
"088","Ragusa",14,1763,0,0,0,1763,1629,0,0,0,1629
"088","Ragusa",15,1708,0,0,0,1708,1631,0,0,0,1631
"088","Ragusa",16,1736,0,0,0,1736,1681,0,0,0,1681
"088","Ragusa",17,1811,0,0,0,1811,1621,0,0,0,1621
"088","Ragusa",18,1908,1,0,0,1909,1794,10,0,0,1804
"088","Ragusa",19,1963,3,0,0,1966,1723,38,0,0,1761
"088","Ragusa",20,1838,7,0,0,1845,1718,81,0,0,1799
"088","Ragusa",21,1988,21,0,0,2009,1728,112,0,0,1840
"088","Ragusa",22,1894,37,0,0,1931,1581,207,0,0,1788
"088","Ragusa",23,2014,71,0,0,2085,1637,271,0,0,1908
"088","Ragusa",24,1861,124,1,0,1986,1590,371,1,0,1962
"088","Ragusa",25,1839,174,0,0,2013,1412,463,1,2,1878
"088","Ragusa",26,1689,287,0,0,1976,1301,629,7,0,1937
"088","Ragusa",27,1630,344,2,0,1976,1181,796,3,1,1981
"088","Ragusa",28,1514,464,2,0,1980,1073,917,7,2,1999
"088","Ragusa",29,1534,591,3,0,2128,983,994,14,4,1995
"088","Ragusa",30,1399,699,3,0,2101,832,1160,7,2,2001
"088","Ragusa",31,1274,835,5,2,2116,803,1204,24,8,2039
"088","Ragusa",32,1131,904,9,0,2044,665,1317,25,3,2010
"088","Ragusa",33,1100,1008,8,0,2116,645,1476,33,3,2157
"088","Ragusa",34,1002,1195,13,0,2210,557,1543,26,8,2134
"088","Ragusa",35,952,1337,13,0,2302,509,1729,40,12,2290
"088","Ragusa",36,871,1480,16,1,2368,461,1757,37,14,2269
"088","Ragusa",37,825,1577,22,0,2424,454,1866,44,15,2379
"088","Ragusa",38,754,1591,31,2,2378,446,1779,57,18,2300
"088","Ragusa",39,644,1620,17,2,2283,379,1784,50,18,2231
"088","Ragusa",40,580,1667,31,4,2282,371,1904,68,12,2355
"088","Ragusa",41,473,1748,52,6,2279,330,1837,73,24,2264
"088","Ragusa",42,480,1875,43,7,2405,318,1861,82,31,2292
"088","Ragusa",43,397,1802,45,6,2250,297,2017,85,34,2433
"088","Ragusa",44,382,1883,46,9,2320,291,1978,78,37,2384
"088","Ragusa",45,357,1879,46,11,2293,253,1973,79,36,2341
"088","Ragusa",46,354,1909,42,3,2308,251,1893,57,50,2251
"088","Ragusa",47,307,1888,45,7,2247,228,1865,73,50,2216
"088","Ragusa",48,256,1821,44,8,2129,221,1950,59,55,2285
"088","Ragusa",49,283,1841,53,10,2187,242,1853,67,58,2220
"088","Ragusa",50,228,1850,58,13,2149,220,1839,64,69,2192
"088","Ragusa",51,180,1809,51,18,2058,197,1920,69,77,2263
"088","Ragusa",52,204,1761,44,15,2024,184,1761,72,103,2120
"088","Ragusa",53,185,1618,48,15,1866,175,1659,72,114,2020
"088","Ragusa",54,156,1644,27,19,1846,157,1598,60,99,1914
"088","Ragusa",55,147,1642,34,28,1851,175,1670,51,115,2011
"088","Ragusa",56,141,1605,42,24,1812,142,1564,47,118,1871
"088","Ragusa",57,113,1639,36,28,1816,143,1664,45,146,1998
"088","Ragusa",58,100,1537,33,17,1687,125,1500,47,160,1832
"088","Ragusa",59,115,1413,35,18,1581,149,1414,49,158,1770
"088","Ragusa",60,117,1391,35,33,1576,120,1412,37,187,1756
"088","Ragusa",61,96,1508,42,38,1684,111,1403,39,204,1757
"088","Ragusa",62,109,1592,33,39,1773,125,1488,37,280,1930
"088","Ragusa",63,78,1534,32,55,1699,133,1556,43,293,2025
"088","Ragusa",64,95,1624,35,47,1801,133,1526,35,333,2027
"088","Ragusa",65,75,1401,23,53,1552,125,1279,37,320,1761
"088","Ragusa",66,63,1257,22,42,1384,97,1044,25,287,1453
"088","Ragusa",67,55,1142,17,56,1270,106,972,26,311,1415
"088","Ragusa",68,49,1122,17,54,1242,93,911,24,352,1380
"088","Ragusa",69,59,1128,19,53,1259,109,908,25,372,1414
"088","Ragusa",70,53,1133,28,59,1273,105,892,20,477,1494
"088","Ragusa",71,65,1294,17,90,1466,110,1009,29,558,1706
"088","Ragusa",72,56,1258,14,92,1420,144,978,27,580,1729
"088","Ragusa",73,51,1129,17,99,1296,115,869,18,600,1602
"088","Ragusa",74,59,1010,10,71,1150,115,698,12,545,1370
"088","Ragusa",75,47,1007,12,95,1161,107,685,22,636,1450
"088","Ragusa",76,48,977,8,94,1127,95,638,19,626,1378
"088","Ragusa",77,44,872,10,106,1032,109,540,13,644,1306
"088","Ragusa",78,33,804,11,122,970,98,511,22,611,1242
"088","Ragusa",79,32,748,8,110,898,94,422,12,719,1247
"088","Ragusa",80,33,709,7,116,865,101,376,14,768,1259
"088","Ragusa",81,31,698,6,139,874,101,356,16,742,1215
"088","Ragusa",82,38,597,8,144,787,99,302,9,709,1119
"088","Ragusa",83,30,574,2,155,761,80,230,11,704,1025
"088","Ragusa",84,15,461,4,130,610,74,159,10,600,843
"088","Ragusa",85,15,410,6,123,554,77,165,9,620,871
"088","Ragusa",86,11,330,2,132,475,69,100,4,585,758
"088","Ragusa",87,18,278,0,111,407,74,105,1,515,695
"088","Ragusa",88,12,217,1,105,335,51,58,3,444,556
"088","Ragusa",89,12,171,1,82,266,50,49,4,443,546
"088","Ragusa",90,6,139,2,80,227,36,19,2,387,444
"088","Ragusa",91,6,102,0,81,189,26,19,2,272,319
"088","Ragusa",92,3,46,0,45,94,19,7,0,161,187
"088","Ragusa",93,0,23,0,31,54,15,7,0,84,106
"088","Ragusa",94,1,24,0,28,53,5,3,1,80,89
"088","Ragusa",95,2,15,0,17,34,17,0,0,79,96
"088","Ragusa",96,0,11,0,23,34,4,2,0,90,96
"088","Ragusa",97,0,9,0,13,22,7,1,0,57,65
"088","Ragusa",98,0,4,0,10,14,5,1,0,33,39
"088","Ragusa",99,0,4,0,4,8,5,1,1,24,31
"088","Ragusa",100,1,3,0,9,13,1,0,0,20,21
"089","Siracusa",0,1900,0,0,0,1900,1734,0,0,0,1734
"089","Siracusa",1,1873,0,0,0,1873,1858,0,0,0,1858
"089","Siracusa",2,1980,0,0,0,1980,1747,0,0,0,1747
"089","Siracusa",3,1916,0,0,0,1916,1856,0,0,0,1856
"089","Siracusa",4,1985,0,0,0,1985,1725,0,0,0,1725
"089","Siracusa",5,2029,0,0,0,2029,1792,0,0,0,1792
"089","Siracusa",6,1995,0,0,0,1995,1873,0,0,0,1873
"089","Siracusa",7,1994,0,0,0,1994,1895,0,0,0,1895
"089","Siracusa",8,2060,0,0,0,2060,1937,0,0,0,1937
"089","Siracusa",9,1994,0,0,0,1994,1911,0,0,0,1911
"089","Siracusa",10,2043,0,0,0,2043,1890,0,0,0,1890
"089","Siracusa",11,1990,0,0,0,1990,1913,0,0,0,1913
"089","Siracusa",12,1953,0,0,0,1953,1966,0,0,0,1966
"089","Siracusa",13,2003,0,0,0,2003,1983,0,0,0,1983
"089","Siracusa",14,2001,0,0,0,2001,1923,0,0,0,1923
"089","Siracusa",15,2007,0,0,0,2007,1979,0,0,0,1979
"089","Siracusa",16,2150,0,0,0,2150,2048,1,0,0,2049
"089","Siracusa",17,2184,0,0,0,2184,2018,0,0,0,2018
"089","Siracusa",18,2299,1,0,0,2300,2254,10,0,0,2264
"089","Siracusa",19,2476,3,0,0,2479,2265,44,0,0,2309
"089","Siracusa",20,2429,19,0,0,2448,2238,99,0,0,2337
"089","Siracusa",21,2463,31,0,0,2494,2252,145,1,0,2398
"089","Siracusa",22,2424,44,0,0,2468,2263,213,0,0,2476
"089","Siracusa",23,2467,86,1,0,2554,2061,301,1,0,2363
"089","Siracusa",24,2422,144,0,0,2566,1934,416,1,0,2351
"089","Siracusa",25,2358,222,0,0,2580,1905,486,4,1,2396
"089","Siracusa",26,2272,260,1,1,2534,1722,696,5,0,2423
"089","Siracusa",27,2284,393,0,0,2677,1712,785,7,0,2504
"089","Siracusa",28,2086,471,1,0,2558,1560,975,9,7,2551
"089","Siracusa",29,1982,662,2,0,2646,1413,1194,11,7,2625
"089","Siracusa",30,1855,754,6,0,2615,1253,1301,10,6,2570
"089","Siracusa",31,1755,962,6,0,2723,1081,1537,28,3,2649
"089","Siracusa",32,1603,1087,14,1,2705,985,1726,21,4,2736
"089","Siracusa",33,1539,1256,13,0,2808,877,1876,37,8,2798
"089","Siracusa",34,1337,1477,14,2,2830,790,1984,40,8,2822
"089","Siracusa",35,1370,1737,25,2,3134,761,2034,41,13,2849
"089","Siracusa",36,1201,1820,23,2,3046,680,2226,68,15,2989
"089","Siracusa",37,1138,1978,36,5,3157,680,2412,75,23,3190
"089","Siracusa",38,1040,2022,36,3,3101,588,2406,65,20,3079
"089","Siracusa",39,937,1976,48,4,2965,535,2470,77,34,3116
"089","Siracusa",40,861,2151,47,2,3061,506,2485,91,33,3115
"089","Siracusa",41,750,2225,55,5,3035,452,2563,88,40,3143
"089","Siracusa",42,672,2391,66,6,3135,414,2503,108,40,3065
"089","Siracusa",43,588,2290,59,12,2949,379,2425,111,31,2946
"089","Siracusa",44,521,2386,75,11,2993,391,2548,99,48,3086
"089","Siracusa",45,545,2348,75,14,2982,309,2583,113,59,3064
"089","Siracusa",46,493,2418,82,16,3009,338,2424,106,61,2929
"089","Siracusa",47,504,2500,77,20,3101,315,2511,96,91,3013
"089","Siracusa",48,382,2425,75,12,2894,305,2536,112,93,3046
"089","Siracusa",49,364,2447,68,19,2898,296,2523,103,101,3023
"089","Siracusa",50,381,2310,73,14,2778,258,2485,112,100,2955
"089","Siracusa",51,313,2336,67,25,2741,250,2396,103,122,2871
"089","Siracusa",52,324,2264,83,16,2687,222,2328,98,139,2787
"089","Siracusa",53,269,2228,55,10,2562,220,2275,79,148,2722
"089","Siracusa",54,275,2176,64,26,2541,220,2252,99,161,2732
"089","Siracusa",55,217,2093,62,34,2406,185,2073,73,173,2504
"089","Siracusa",56,241,2191,56,39,2527,197,2208,96,207,2708
"089","Siracusa",57,204,2146,44,38,2432,185,2214,71,195,2665
"089","Siracusa",58,189,1965,52,38,2244,167,1963,67,223,2420
"089","Siracusa",59,168,1969,53,45,2235,158,1895,72,255,2380
"089","Siracusa",60,177,1991,60,54,2282,148,1919,53,270,2390
"089","Siracusa",61,152,2062,61,53,2328,160,2000,66,333,2559
"089","Siracusa",62,144,2106,41,55,2346,138,1958,70,348,2514
"089","Siracusa",63,162,2276,51,65,2554,171,2042,63,442,2718
"089","Siracusa",64,154,2425,52,83,2714,164,2100,58,482,2804
"089","Siracusa",65,142,2113,47,88,2390,152,1915,50,469,2586
"089","Siracusa",66,100,1920,27,88,2135,160,1615,61,465,2301
"089","Siracusa",67,98,1693,33,86,1910,105,1403,40,477,2025
"089","Siracusa",68,111,1629,26,81,1847,121,1326,33,492,1972
"089","Siracusa",69,86,1534,25,84,1729,137,1272,40,551,2000
"089","Siracusa",70,91,1561,28,100,1780,122,1213,41,596,1972
"089","Siracusa",71,94,1735,31,109,1969,126,1384,33,737,2280
"089","Siracusa",72,93,1570,21,138,1822,118,1201,33,782,2134
"089","Siracusa",73,72,1530,27,121,1750,112,1129,36,809,2086
"089","Siracusa",74,64,1236,26,149,1475,108,861,20,725,1714
"089","Siracusa",75,69,1258,21,134,1482,97,862,24,739,1722
"089","Siracusa",76,52,1248,17,183,1500,112,796,28,842,1778
"089","Siracusa",77,61,1137,8,187,1393,100,662,22,949,1733
"089","Siracusa",78,47,1049,18,176,1290,107,610,20,895,1632
"089","Siracusa",79,50,882,13,154,1099,87,504,21,869,1481
"089","Siracusa",80,49,865,6,176,1096,112,475,10,919,1516
"089","Siracusa",81,38,817,5,227,1087,94,383,27,941,1445
"089","Siracusa",82,31,704,6,191,932,93,308,12,904,1317
"089","Siracusa",83,24,573,6,174,777,103,246,11,848,1208
"089","Siracusa",84,22,494,6,159,681,88,168,15,744,1015
"089","Siracusa",85,24,419,1,177,621,73,182,9,731,995
"089","Siracusa",86,16,346,0,140,502,76,99,10,704,889
"089","Siracusa",87,14,275,8,150,447,72,116,9,699,896
"089","Siracusa",88,19,227,2,130,378,62,67,13,525,667
"089","Siracusa",89,12,163,4,124,303,59,46,6,483,594
"089","Siracusa",90,9,131,1,114,255,42,32,3,381,458
"089","Siracusa",91,11,93,0,76,180,27,17,4,373,421
"089","Siracusa",92,3,42,0,50,95,27,11,2,212,252
"089","Siracusa",93,1,30,0,37,68,9,4,1,117,131
"089","Siracusa",94,1,19,0,32,52,9,3,3,108,123
"089","Siracusa",95,1,17,1,32,51,8,6,0,110,124
"089","Siracusa",96,2,19,0,23,44,15,4,1,93,113
"089","Siracusa",97,1,14,1,12,28,7,1,1,59,68
"089","Siracusa",98,0,7,0,7,14,7,3,1,51,62
"089","Siracusa",99,1,2,1,11,15,4,3,0,33,40
"089","Siracusa",100,1,2,0,13,16,4,1,0,42,47
"090","Sassari",0,1326,0,0,0,1326,1236,0,0,0,1236
"090","Sassari",1,1352,0,0,0,1352,1260,0,0,0,1260
"090","Sassari",2,1363,0,0,0,1363,1235,0,0,0,1235
"090","Sassari",3,1313,0,0,0,1313,1260,0,0,0,1260
"090","Sassari",4,1360,0,0,0,1360,1344,0,0,0,1344
"090","Sassari",5,1334,0,0,0,1334,1277,0,0,0,1277
"090","Sassari",6,1362,0,0,0,1362,1325,0,0,0,1325
"090","Sassari",7,1395,0,0,0,1395,1311,0,0,0,1311
"090","Sassari",8,1404,0,0,0,1404,1358,0,0,0,1358
"090","Sassari",9,1348,0,0,0,1348,1323,0,0,0,1323
"090","Sassari",10,1396,0,0,0,1396,1319,0,0,0,1319
"090","Sassari",11,1444,0,0,0,1444,1345,0,0,0,1345
"090","Sassari",12,1424,0,0,0,1424,1355,0,0,0,1355
"090","Sassari",13,1462,0,0,0,1462,1335,0,0,0,1335
"090","Sassari",14,1389,0,0,0,1389,1362,0,0,0,1362
"090","Sassari",15,1508,0,0,0,1508,1427,0,0,0,1427
"090","Sassari",16,1533,0,0,0,1533,1393,0,0,0,1393
"090","Sassari",17,1535,0,0,0,1535,1419,0,0,0,1419
"090","Sassari",18,1613,0,0,0,1613,1551,7,0,0,1558
"090","Sassari",19,1702,4,3,0,1709,1610,13,0,0,1623
"090","Sassari",20,1738,6,3,0,1747,1588,24,0,0,1612
"090","Sassari",21,1766,14,5,0,1785,1698,39,0,0,1737
"090","Sassari",22,1760,13,3,0,1776,1701,63,0,0,1764
"090","Sassari",23,1743,19,4,0,1766,1594,89,0,0,1683
"090","Sassari",24,1821,51,6,0,1878,1624,128,0,0,1752
"090","Sassari",25,1762,80,7,0,1849,1566,193,0,0,1759
"090","Sassari",26,1798,89,6,0,1893,1531,274,0,0,1805
"090","Sassari",27,1758,122,7,0,1887,1482,354,2,1,1839
"090","Sassari",28,1686,203,8,0,1897,1404,447,1,10,1862
"090","Sassari",29,1735,279,8,0,2022,1340,580,9,9,1938
"090","Sassari",30,1645,334,8,5,1992,1250,695,16,1,1962
"090","Sassari",31,1595,481,2,9,2087,1119,799,20,4,1942
"090","Sassari",32,1451,608,11,1,2071,1161,936,26,4,2127
"090","Sassari",33,1557,753,12,9,2331,1105,1099,24,9,2237
"090","Sassari",34,1556,875,17,0,2448,1017,1220,27,1,2265
"090","Sassari",35,1517,1008,15,8,2548,1017,1375,41,20,2453
"090","Sassari",36,1517,1157,32,2,2708,957,1488,35,14,2494
"090","Sassari",37,1382,1171,36,4,2593,969,1622,52,20,2663
"090","Sassari",38,1280,1443,27,8,2758,859,1729,52,27,2667
"090","Sassari",39,1168,1486,37,9,2700,764,1765,65,26,2620
"090","Sassari",40,1038,1468,38,6,2550,741,1830,70,32,2673
"090","Sassari",41,952,1553,52,11,2568,665,1779,88,30,2562
"090","Sassari",42,954,1587,59,11,2611,649,1911,84,39,2683
"090","Sassari",43,843,1704,60,11,2618,591,1885,95,34,2605
"090","Sassari",44,794,1721,56,11,2582,572,1999,96,45,2712
"090","Sassari",45,739,1842,62,18,2661,516,2115,108,42,2781
"090","Sassari",46,715,1955,74,11,2755,545,2087,107,56,2795
"090","Sassari",47,617,1965,99,12,2693,521,2137,113,66,2837
"090","Sassari",48,581,1913,96,15,2605,482,2095,109,98,2784
"090","Sassari",49,548,1936,92,17,2593,406,1998,110,87,2601
"090","Sassari",50,480,1849,66,21,2416,388,2061,70,79,2598
"090","Sassari",51,460,1897,77,28,2462,366,1985,94,115,2560
"090","Sassari",52,419,1817,71,21,2328,325,1941,99,105,2470
"090","Sassari",53,359,1860,70,26,2315,335,1895,93,133,2456
"090","Sassari",54,353,1893,77,19,2342,310,1860,93,146,2409
"090","Sassari",55,339,1844,70,37,2290,294,1758,92,141,2285
"090","Sassari",56,341,1770,67,30,2208,295,1788,78,156,2317
"090","Sassari",57,372,1822,63,38,2295,279,1791,81,180,2331
"090","Sassari",58,339,1715,73,22,2149,255,1666,93,154,2168
"090","Sassari",59,277,1636,53,45,2011,273,1684,62,217,2236
"090","Sassari",60,254,1700,52,36,2042,258,1675,57,228,2218
"090","Sassari",61,263,1729,55,57,2104,289,1608,60,262,2219
"090","Sassari",62,250,1737,38,60,2085,193,1626,41,240,2100
"090","Sassari",63,253,1714,50,56,2073,281,1651,53,297,2282
"090","Sassari",64,232,1709,34,72,2047,252,1523,39,314,2128
"090","Sassari",65,192,1629,46,61,1928,217,1462,52,344,2075
"090","Sassari",66,193,1469,26,49,1737,233,1342,35,335,1945
"090","Sassari",67,185,1499,24,74,1782,229,1297,47,398,1971
"090","Sassari",68,167,1420,32,76,1695,224,1231,32,456,1943
"090","Sassari",69,204,1355,30,85,1674,215,1226,23,505,1969
"090","Sassari",70,171,1256,26,84,1537,232,1150,25,496,1903
"090","Sassari",71,200,1414,35,93,1742,222,1121,20,602,1965
"090","Sassari",72,213,1237,25,102,1577,228,1067,29,609,1933
"090","Sassari",73,152,1141,18,89,1400,251,870,17,600,1738
"090","Sassari",74,157,1022,12,116,1307,193,837,19,615,1664
"090","Sassari",75,117,1016,17,120,1270,222,725,14,630,1591
"090","Sassari",76,125,858,6,112,1101,209,651,10,710,1580
"090","Sassari",77,150,963,9,128,1250,218,627,11,703,1559
"090","Sassari",78,127,878,10,106,1121,211,523,12,738,1484
"090","Sassari",79,109,740,6,106,961,223,453,7,699,1382
"090","Sassari",80,113,738,9,123,983,209,359,8,724,1300
"090","Sassari",81,113,640,6,128,887,231,323,3,777,1334
"090","Sassari",82,79,525,3,132,739,198,260,6,748,1212
"090","Sassari",83,72,460,3,132,667,188,232,5,699,1124
"090","Sassari",84,67,404,2,115,588,177,196,2,669,1044
"090","Sassari",85,65,363,2,112,542,171,139,4,628,942
"090","Sassari",86,54,256,0,96,406,142,114,13,580,849
"090","Sassari",87,44,253,1,99,397,138,96,0,598,832
"090","Sassari",88,32,209,2,97,340,126,60,3,505,694
"090","Sassari",89,22,172,0,93,287,79,48,4,395,526
"090","Sassari",90,14,114,2,73,203,65,31,3,374,473
"090","Sassari",91,23,91,0,55,169,58,20,0,279,357
"090","Sassari",92,11,54,1,44,110,37,5,1,188,231
"090","Sassari",93,3,30,1,39,73,23,6,0,115,144
"090","Sassari",94,3,18,0,21,42,23,5,2,94,124
"090","Sassari",95,1,25,0,20,46,19,3,0,83,105
"090","Sassari",96,6,19,0,14,39,28,0,0,86,114
"090","Sassari",97,2,12,0,15,29,10,0,0,57,67
"090","Sassari",98,1,8,0,16,25,10,1,0,38,49
"090","Sassari",99,1,1,0,14,16,4,0,0,16,20
"090","Sassari",100,4,2,0,8,14,14,3,0,42,59
"091","Nuoro",0,654,0,0,0,654,634,0,0,0,634
"091","Nuoro",1,664,0,0,0,664,612,0,0,0,612
"091","Nuoro",2,711,0,0,0,711,621,0,0,0,621
"091","Nuoro",3,649,0,0,0,649,631,0,0,0,631
"091","Nuoro",4,668,0,0,0,668,586,0,0,0,586
"091","Nuoro",5,725,0,0,0,725,634,0,0,0,634
"091","Nuoro",6,690,0,0,0,690,699,0,0,0,699
"091","Nuoro",7,702,0,0,0,702,635,0,0,0,635
"091","Nuoro",8,709,0,0,0,709,671,0,0,0,671
"091","Nuoro",9,680,0,0,0,680,652,0,0,0,652
"091","Nuoro",10,765,0,0,0,765,693,0,0,0,693
"091","Nuoro",11,739,0,0,0,739,691,0,0,0,691
"091","Nuoro",12,747,0,0,0,747,714,0,0,0,714
"091","Nuoro",13,732,0,0,0,732,739,0,0,0,739
"091","Nuoro",14,778,0,0,0,778,710,0,0,0,710
"091","Nuoro",15,744,0,0,0,744,683,0,0,0,683
"091","Nuoro",16,837,0,0,0,837,787,0,0,0,787
"091","Nuoro",17,843,0,0,0,843,798,1,0,0,799
"091","Nuoro",18,860,0,0,0,860,813,1,0,0,814
"091","Nuoro",19,886,0,0,0,886,800,4,0,0,804
"091","Nuoro",20,909,0,0,0,909,818,13,0,0,831
"091","Nuoro",21,925,3,0,1,929,897,21,0,0,918
"091","Nuoro",22,877,6,0,0,883,786,31,0,0,817
"091","Nuoro",23,967,9,0,0,976,885,51,0,0,936
"091","Nuoro",24,862,18,0,0,880,809,80,0,0,889
"091","Nuoro",25,873,29,0,0,902,774,113,0,0,887
"091","Nuoro",26,904,47,0,0,951,788,153,0,0,941
"091","Nuoro",27,867,63,0,0,930,676,190,3,0,869
"091","Nuoro",28,892,106,0,0,998,694,253,2,1,950
"091","Nuoro",29,860,126,1,0,987,647,291,2,0,940
"091","Nuoro",30,868,178,0,0,1046,606,341,2,4,953
"091","Nuoro",31,811,235,1,0,1047,554,360,6,2,922
"091","Nuoro",32,743,260,3,0,1006,480,438,3,2,923
"091","Nuoro",33,771,327,1,0,1099,495,571,11,1,1078
"091","Nuoro",34,767,384,2,1,1154,434,585,12,7,1038
"091","Nuoro",35,720,413,5,0,1138,443,624,13,3,1083
"091","Nuoro",36,661,497,5,0,1163,407,656,11,7,1081
"091","Nuoro",37,649,585,8,0,1242,368,665,15,13,1061
"091","Nuoro",38,590,573,8,1,1172,372,772,22,10,1176
"091","Nuoro",39,533,620,14,1,1168,301,786,17,13,1117
"091","Nuoro",40,485,678,13,1,1177,322,772,24,9,1127
"091","Nuoro",41,480,648,12,3,1143,286,805,24,12,1127
"091","Nuoro",42,473,721,19,3,1216,286,882,33,23,1224
"091","Nuoro",43,459,752,14,0,1225,272,877,21,19,1189
"091","Nuoro",44,470,830,21,1,1322,236,920,20,33,1209
"091","Nuoro",45,423,895,21,1,1340,235,971,41,31,1278
"091","Nuoro",46,373,871,17,5,1266,229,910,29,31,1199
"091","Nuoro",47,335,947,33,6,1321,235,1002,35,36,1308
"091","Nuoro",48,331,882,30,4,1247,241,913,29,38,1221
"091","Nuoro",49,297,861,29,7,1194,224,952,28,43,1247
"091","Nuoro",50,318,852,21,10,1201,211,954,26,61,1252
"091","Nuoro",51,273,841,21,9,1144,202,896,23,46,1167
"091","Nuoro",52,282,864,28,4,1178,157,900,28,49,1134
"091","Nuoro",53,273,884,21,7,1185,177,845,23,59,1104
"091","Nuoro",54,258,820,21,3,1102,199,870,29,69,1167
"091","Nuoro",55,241,841,15,17,1114,176,873,26,69,1144
"091","Nuoro",56,226,796,20,14,1056,182,848,17,74,1121
"091","Nuoro",57,228,845,21,15,1109,156,847,26,93,1122
"091","Nuoro",58,219,770,24,14,1027,165,735,17,95,1012
"091","Nuoro",59,207,860,22,17,1106,153,796,16,104,1069
"091","Nuoro",60,198,776,21,20,1015,139,729,26,115,1009
"091","Nuoro",61,166,812,12,22,1012,141,728,16,142,1027
"091","Nuoro",62,161,792,13,21,987,138,695,12,120,965
"091","Nuoro",63,186,826,15,26,1053,159,716,23,172,1070
"091","Nuoro",64,170,732,10,29,941,121,664,7,176,968
"091","Nuoro",65,137,686,14,33,870,142,560,12,165,879
"091","Nuoro",66,157,666,14,26,863,149,585,8,202,944
"091","Nuoro",67,155,643,12,28,838,147,588,10,195,940
"091","Nuoro",68,146,603,12,29,790,162,579,6,182,929
"091","Nuoro",69,119,601,11,36,767,128,557,9,259,953
"091","Nuoro",70,131,557,4,32,724,127,488,7,253,875
"091","Nuoro",71,143,604,8,35,790,154,503,8,304,969
"091","Nuoro",72,115,603,5,37,760,160,471,1,312,944
"091","Nuoro",73,118,552,5,49,724,156,402,3,303,864
"091","Nuoro",74,109,456,5,49,619,151,327,6,324,808
"091","Nuoro",75,96,483,3,53,635,192,333,1,334,860
"091","Nuoro",76,94,439,6,48,587,164,304,2,351,821
"091","Nuoro",77,89,434,2,47,572,171,251,7,375,804
"091","Nuoro",78,68,427,6,39,540,173,238,8,371,790
"091","Nuoro",79,72,353,1,54,480,170,208,3,394,775
"091","Nuoro",80,73,339,1,52,465,134,178,3,355,670
"091","Nuoro",81,52,319,1,58,430,135,181,3,365,684
"091","Nuoro",82,62,273,2,54,391,134,121,1,362,618
"091","Nuoro",83,40,258,0,64,362,138,112,1,368,619
"091","Nuoro",84,41,210,0,61,312,115,77,0,321,513
"091","Nuoro",85,42,201,1,50,294,98,75,1,354,528
"091","Nuoro",86,38,156,0,57,251,78,64,0,309,451
"091","Nuoro",87,25,146,1,56,228,69,41,1,309,420
"091","Nuoro",88,21,109,1,55,186,70,27,1,252,350
"091","Nuoro",89,19,80,0,42,141,65,15,0,233,313
"091","Nuoro",90,8,57,1,41,107,48,17,0,166,231
"091","Nuoro",91,8,52,0,30,90,31,15,1,151,198
"091","Nuoro",92,4,41,0,28,73,24,9,0,112,145
"091","Nuoro",93,1,13,0,16,30,17,3,0,70,90
"091","Nuoro",94,3,13,0,10,26,13,9,1,44,67
"091","Nuoro",95,1,15,0,15,31,13,2,0,58,73
"091","Nuoro",96,1,4,0,15,20,14,1,1,47,63
"091","Nuoro",97,0,5,0,12,17,14,0,1,34,49
"091","Nuoro",98,3,5,0,7,15,7,0,0,22,29
"091","Nuoro",99,3,4,0,4,11,1,1,0,22,24
"091","Nuoro",100,1,4,0,7,12,8,1,0,30,39
"092","Cagliari",0,2247,0,0,0,2247,2097,0,0,0,2097
"092","Cagliari",1,2301,0,0,0,2301,2194,0,0,0,2194
"092","Cagliari",2,2379,0,0,0,2379,2155,0,0,0,2155
"092","Cagliari",3,2287,0,0,0,2287,2225,0,0,0,2225
"092","Cagliari",4,2285,0,0,0,2285,2201,0,0,0,2201
"092","Cagliari",5,2411,0,0,0,2411,2210,0,0,0,2210
"092","Cagliari",6,2402,0,0,0,2402,2096,0,0,0,2096
"092","Cagliari",7,2282,0,0,0,2282,2150,0,0,0,2150
"092","Cagliari",8,2384,0,0,0,2384,2271,0,0,0,2271
"092","Cagliari",9,2339,0,0,0,2339,2185,0,0,0,2185
"092","Cagliari",10,2388,0,0,0,2388,2258,0,0,0,2258
"092","Cagliari",11,2421,0,0,0,2421,2285,0,0,0,2285
"092","Cagliari",12,2298,0,0,0,2298,2198,0,0,0,2198
"092","Cagliari",13,2334,0,0,0,2334,2076,0,0,0,2076
"092","Cagliari",14,2290,0,0,0,2290,2135,0,0,0,2135
"092","Cagliari",15,2436,0,0,0,2436,2149,0,0,0,2149
"092","Cagliari",16,2488,0,0,0,2488,2206,0,0,0,2206
"092","Cagliari",17,2553,0,0,0,2553,2346,1,0,0,2347
"092","Cagliari",18,2482,0,0,0,2482,2458,3,0,0,2461
"092","Cagliari",19,2655,2,0,0,2657,2532,14,0,0,2546
"092","Cagliari",20,2811,2,0,0,2813,2571,36,1,0,2608
"092","Cagliari",21,2962,9,0,0,2971,2703,55,0,0,2758
"092","Cagliari",22,2928,19,0,0,2947,2654,63,0,0,2717
"092","Cagliari",23,2983,41,0,0,3024,2667,134,0,1,2802
"092","Cagliari",24,2919,53,1,0,2973,2632,211,1,0,2844
"092","Cagliari",25,2896,97,0,0,2993,2730,257,0,0,2987
"092","Cagliari",26,3068,136,0,0,3204,2661,403,3,0,3067
"092","Cagliari",27,3075,250,1,0,3326,2523,555,3,3,3084
"092","Cagliari",28,3031,312,0,0,3343,2595,663,6,0,3264
"092","Cagliari",29,3103,437,1,0,3541,2618,939,13,2,3572
"092","Cagliari",30,2898,609,7,2,3516,2356,1166,12,2,3536
"092","Cagliari",31,2943,778,11,1,3733,2260,1315,27,4,3606
"092","Cagliari",32,2780,971,9,0,3760,2071,1508,32,2,3613
"092","Cagliari",33,2796,1246,13,2,4057,2074,1773,38,6,3891
"092","Cagliari",34,2724,1392,21,2,4139,2003,2015,40,11,4069
"092","Cagliari",35,2600,1621,22,2,4245,1992,2251,48,10,4301
"092","Cagliari",36,2573,1942,36,4,4555,1905,2517,85,16,4523
"092","Cagliari",37,2599,2180,46,3,4828,1845,2739,84,17,4685
"092","Cagliari",38,2433,2372,71,5,4881,1653,2927,101,30,4711
"092","Cagliari",39,2127,2534,47,6,4714,1527,3043,128,23,4721
"092","Cagliari",40,1957,2562,77,5,4601,1435,3220,132,38,4825
"092","Cagliari",41,1750,2677,82,6,4515,1303,3111,152,53,4619
"092","Cagliari",42,1669,2830,115,10,4624,1185,3394,155,51,4785
"092","Cagliari",43,1502,2872,105,5,4484,1150,3328,193,47,4718
"092","Cagliari",44,1493,3061,134,13,4701,1108,3485,165,57,4815
"092","Cagliari",45,1344,3180,129,13,4666,1059,3410,192,76,4737
"092","Cagliari",46,1172,3281,138,13,4604,990,3566,191,105,4852
"092","Cagliari",47,1187,3390,154,23,4754,899,3665,198,109,4871
"092","Cagliari",48,981,3309,156,25,4471,872,3483,216,114,4685
"092","Cagliari",49,915,3173,161,25,4274,790,3467,222,121,4600
"092","Cagliari",50,799,3129,166,34,4128,754,3406,202,146,4508
"092","Cagliari",51,750,3193,159,30,4132,693,3186,216,165,4260
"092","Cagliari",52,673,3148,155,34,4010,678,3240,247,186,4351
"092","Cagliari",53,611,3128,154,38,3931,589,3130,246,188,4153
"092","Cagliari",54,590,3032,154,46,3822,576,3216,216,218,4226
"092","Cagliari",55,541,3051,155,46,3793,511,3237,206,226,4180
"092","Cagliari",56,464,3052,133,43,3692,511,3036,167,242,3956
"092","Cagliari",57,451,3085,134,63,3733,533,3120,184,290,4127
"092","Cagliari",58,373,2924,134,64,3495,487,2947,163,310,3907
"092","Cagliari",59,376,2914,123,66,3479,422,2868,177,312,3779
"092","Cagliari",60,335,2856,111,59,3361,423,2815,145,347,3730
"092","Cagliari",61,300,2879,119,88,3386,444,2758,156,394,3752
"092","Cagliari",62,332,2826,95,83,3336,378,2730,132,416,3656
"092","Cagliari",63,288,2861,102,105,3356,387,2792,145,440,3764
"092","Cagliari",64,260,2808,99,101,3268,392,2643,109,506,3650
"092","Cagliari",65,217,2776,86,106,3185,393,2328,103,493,3317
"092","Cagliari",66,253,2517,68,82,2920,360,2279,111,527,3277
"092","Cagliari",67,205,2314,66,133,2718,320,2025,81,538,2964
"092","Cagliari",68,168,2224,71,108,2571,340,2039,78,621,3078
"092","Cagliari",69,193,2410,51,135,2789,335,1987,62,735,3119
"092","Cagliari",70,181,2219,44,146,2590,333,1845,68,705,2951
"092","Cagliari",71,237,2319,55,167,2778,346,1928,75,908,3257
"092","Cagliari",72,201,2204,42,154,2601,341,1664,58,830,2893
"092","Cagliari",73,197,1900,33,148,2278,302,1453,60,882,2697
"092","Cagliari",74,167,1757,41,189,2154,303,1319,49,880,2551
"092","Cagliari",75,173,1702,33,177,2085,306,1219,34,982,2541
"092","Cagliari",76,111,1459,22,163,1755,278,1071,30,891,2270
"092","Cagliari",77,118,1431,18,184,1751,309,1013,34,1048,2404
"092","Cagliari",78,124,1369,27,206,1726,320,907,31,1029,2287
"092","Cagliari",79,123,1151,20,191,1485,276,752,24,1044,2096
"092","Cagliari",80,98,1070,13,197,1378,239,607,24,1091,1961
"092","Cagliari",81,95,1055,13,209,1372,258,591,20,1182,2051
"092","Cagliari",82,77,885,8,177,1147,250,463,20,1119,1852
"092","Cagliari",83,77,793,9,193,1072,232,399,23,1123,1777
"092","Cagliari",84,53,656,11,151,871,207,321,16,996,1540
"092","Cagliari",85,46,579,1,181,807,245,258,12,961,1476
"092","Cagliari",86,34,418,4,161,617,170,162,11,870,1213
"092","Cagliari",87,31,356,3,137,527,178,132,8,871,1189
"092","Cagliari",88,30,302,5,144,481,126,100,15,720,961
"092","Cagliari",89,21,274,2,137,434,102,76,5,612,795
"092","Cagliari",90,17,174,1,117,309,106,53,7,540,706
"092","Cagliari",91,13,141,1,119,274,71,34,5,525,635
"092","Cagliari",92,5,84,2,77,168,46,27,0,322,395
"092","Cagliari",93,4,48,2,32,86,33,10,0,221,264
"092","Cagliari",94,4,36,0,26,66,31,5,3,162,201
"092","Cagliari",95,2,24,1,37,64,34,5,1,158,198
"092","Cagliari",96,3,28,1,45,77,27,5,3,155,190
"092","Cagliari",97,1,19,0,35,55,20,3,0,104,127
"092","Cagliari",98,3,12,0,22,37,12,1,0,70,83
"092","Cagliari",99,2,8,0,17,27,9,1,0,54,64
"092","Cagliari",100,4,6,0,15,25,8,0,0,72,80
"093","Pordenone",0,1563,0,0,0,1563,1362,0,0,0,1362
"093","Pordenone",1,1530,0,0,0,1530,1441,0,0,0,1441
"093","Pordenone",2,1630,0,0,0,1630,1500,0,0,0,1500
"093","Pordenone",3,1601,0,0,0,1601,1475,0,0,0,1475
"093","Pordenone",4,1612,0,0,0,1612,1526,0,0,0,1526
"093","Pordenone",5,1567,0,0,0,1567,1469,0,0,0,1469
"093","Pordenone",6,1459,0,0,0,1459,1413,0,0,0,1413
"093","Pordenone",7,1460,0,0,0,1460,1509,0,0,0,1509
"093","Pordenone",8,1454,0,0,0,1454,1349,0,0,0,1349
"093","Pordenone",9,1402,0,0,0,1402,1388,0,0,0,1388
"093","Pordenone",10,1529,0,0,0,1529,1332,0,0,0,1332
"093","Pordenone",11,1460,0,0,0,1460,1407,0,0,0,1407
"093","Pordenone",12,1443,0,0,0,1443,1339,0,0,0,1339
"093","Pordenone",13,1404,0,0,0,1404,1338,0,0,0,1338
"093","Pordenone",14,1332,0,0,0,1332,1276,0,0,0,1276
"093","Pordenone",15,1416,0,0,0,1416,1338,0,0,0,1338
"093","Pordenone",16,1346,0,0,0,1346,1195,0,0,0,1195
"093","Pordenone",17,1340,0,0,0,1340,1199,1,0,0,1200
"093","Pordenone",18,1367,0,0,0,1367,1261,2,0,0,1263
"093","Pordenone",19,1423,1,0,0,1424,1316,16,0,0,1332
"093","Pordenone",20,1414,1,0,0,1415,1313,39,0,0,1352
"093","Pordenone",21,1378,8,0,0,1386,1285,94,0,0,1379
"093","Pordenone",22,1436,14,1,0,1451,1234,127,1,0,1362
"093","Pordenone",23,1448,30,0,0,1478,1249,193,1,1,1444
"093","Pordenone",24,1406,65,0,0,1471,1154,305,3,0,1462
"093","Pordenone",25,1416,106,0,0,1522,1158,382,1,0,1541
"093","Pordenone",26,1421,156,0,0,1577,1142,467,3,0,1612
"093","Pordenone",27,1445,219,1,0,1665,1055,549,3,2,1609
"093","Pordenone",28,1407,338,1,0,1746,997,656,8,1,1662
"093","Pordenone",29,1446,458,1,0,1905,1010,837,14,2,1863
"093","Pordenone",30,1398,587,4,0,1989,953,916,15,3,1887
"093","Pordenone",31,1364,735,4,2,2105,872,1042,11,4,1929
"093","Pordenone",32,1291,849,10,3,2153,808,1131,20,5,1964
"093","Pordenone",33,1368,1000,15,0,2383,834,1257,33,3,2127
"093","Pordenone",34,1267,1085,17,2,2371,719,1334,42,5,2100
"093","Pordenone",35,1240,1186,20,2,2448,779,1429,46,7,2261
"093","Pordenone",36,1197,1297,23,5,2522,728,1570,67,10,2375
"093","Pordenone",37,1137,1459,35,4,2635,708,1746,93,12,2559
"093","Pordenone",38,1098,1470,35,1,2604,620,1711,97,12,2440
"093","Pordenone",39,967,1571,61,1,2600,583,1928,88,17,2616
"093","Pordenone",40,887,1629,70,6,2592,571,1808,116,15,2510
"093","Pordenone",41,868,1648,66,2,2584,562,1900,98,25,2585
"093","Pordenone",42,792,1801,90,5,2688,489,1901,156,21,2567
"093","Pordenone",43,766,1880,90,6,2742,510,1900,127,36,2573
"093","Pordenone",44,676,1835,105,7,2623,453,1972,159,22,2606
"093","Pordenone",45,630,1773,123,8,2534,441,1886,170,35,2532
"093","Pordenone",46,625,1865,105,10,2605,396,1893,157,22,2468
"093","Pordenone",47,550,1964,122,7,2643,428,1957,168,51,2604
"093","Pordenone",48,496,1816,135,12,2459,323,1975,156,53,2507
"093","Pordenone",49,432,1776,122,15,2345,303,1838,140,52,2333
"093","Pordenone",50,445,1752,122,20,2339,236,1777,158,49,2220
"093","Pordenone",51,340,1682,110,8,2140,229,1730,162,63,2184
"093","Pordenone",52,356,1694,109,8,2167,202,1731,154,75,2162
"093","Pordenone",53,291,1542,105,16,1954,204,1656,130,80,2070
"093","Pordenone",54,314,1537,94,18,1963,207,1641,152,83,2083
"093","Pordenone",55,271,1589,104,17,1981,177,1557,123,118,1975
"093","Pordenone",56,259,1510,95,28,1892,152,1557,105,113,1927
"093","Pordenone",57,241,1489,90,25,1845,169,1596,124,123,2012
"093","Pordenone",58,241,1531,96,32,1900,137,1561,104,124,1926
"093","Pordenone",59,230,1494,74,37,1835,154,1632,99,156,2041
"093","Pordenone",60,227,1498,69,37,1831,150,1547,92,173,1962
"093","Pordenone",61,221,1592,83,51,1947,138,1544,106,209,1997
"093","Pordenone",62,205,1532,79,45,1861,128,1495,76,204,1903
"093","Pordenone",63,199,1701,74,59,2033,126,1605,89,235,2055
"093","Pordenone",64,177,1608,57,67,1909,120,1571,66,290,2047
"093","Pordenone",65,205,1745,57,77,2084,140,1640,58,331,2169
"093","Pordenone",66,146,1204,36,71,1457,79,1065,48,270,1462
"093","Pordenone",67,176,1404,43,73,1696,96,1281,46,362,1785
"093","Pordenone",68,177,1382,39,106,1704,90,1233,54,386,1763
"093","Pordenone",69,162,1354,47,80,1643,114,1233,52,426,1825
"093","Pordenone",70,146,1311,32,81,1570,89,1134,44,480,1747
"093","Pordenone",71,159,1378,32,109,1678,106,1174,39,546,1865
"093","Pordenone",72,127,1311,24,111,1573,114,1045,37,618,1814
"093","Pordenone",73,129,1246,23,101,1499,95,992,28,617,1732
"093","Pordenone",74,111,1143,25,130,1409,91,872,27,599,1589
"093","Pordenone",75,73,962,12,116,1163,98,719,22,624,1463
"093","Pordenone",76,97,938,21,124,1180,67,657,27,646,1397
"093","Pordenone",77,84,786,11,135,1016,91,568,27,692,1378
"093","Pordenone",78,82,746,13,131,972,96,505,10,733,1344
"093","Pordenone",79,80,703,7,132,922,74,445,19,749,1287
"093","Pordenone",80,74,610,8,93,785,77,380,8,755,1220
"093","Pordenone",81,55,596,8,98,757,95,337,11,787,1230
"093","Pordenone",82,66,497,4,128,695,94,310,9,843,1256
"093","Pordenone",83,49,457,6,114,626,77,223,10,855,1165
"093","Pordenone",84,42,424,3,113,582,70,212,10,819,1111
"093","Pordenone",85,42,360,1,117,520,79,172,8,832,1091
"093","Pordenone",86,37,301,2,119,459,66,134,9,768,977
"093","Pordenone",87,42,260,0,135,437,86,107,6,749,948
"093","Pordenone",88,20,207,2,100,329,76,68,6,718,868
"093","Pordenone",89,17,154,0,83,254,56,55,2,649,762
"093","Pordenone",90,16,135,0,81,232,59,34,4,611,708
"093","Pordenone",91,13,102,2,65,182,48,28,4,516,596
"093","Pordenone",92,7,40,0,28,75,20,6,3,254,283
"093","Pordenone",93,2,21,0,20,43,11,4,1,139,155
"093","Pordenone",94,4,17,0,16,37,14,4,1,136,155
"093","Pordenone",95,4,10,0,18,32,18,1,0,138,157
"093","Pordenone",96,1,21,1,21,44,19,2,1,145,167
"093","Pordenone",97,0,6,0,16,22,7,1,0,115,123
"093","Pordenone",98,2,8,0,9,19,11,1,0,84,96
"093","Pordenone",99,0,1,0,8,9,6,0,0,63,69
"093","Pordenone",100,2,0,0,11,13,12,0,0,102,114
"094","Isernia",0,301,0,0,0,301,309,0,0,0,309
"094","Isernia",1,347,0,0,0,347,312,0,0,0,312
"094","Isernia",2,339,0,0,0,339,297,0,0,0,297
"094","Isernia",3,354,0,0,0,354,308,0,0,0,308
"094","Isernia",4,345,0,0,0,345,340,0,0,0,340
"094","Isernia",5,325,0,0,0,325,329,0,0,0,329
"094","Isernia",6,345,0,0,0,345,345,0,0,0,345
"094","Isernia",7,341,0,0,0,341,312,0,0,0,312
"094","Isernia",8,348,0,0,0,348,302,0,0,0,302
"094","Isernia",9,340,0,0,0,340,346,0,0,0,346
"094","Isernia",10,344,0,0,0,344,334,0,0,0,334
"094","Isernia",11,382,0,0,0,382,334,0,0,0,334
"094","Isernia",12,359,0,0,0,359,334,0,0,0,334
"094","Isernia",13,395,0,0,0,395,362,0,0,0,362
"094","Isernia",14,395,0,0,0,395,371,0,0,0,371
"094","Isernia",15,404,0,0,0,404,389,0,0,0,389
"094","Isernia",16,373,0,0,0,373,408,0,0,0,408
"094","Isernia",17,439,0,0,0,439,406,0,0,0,406
"094","Isernia",18,440,0,0,0,440,441,2,0,0,443
"094","Isernia",19,473,1,0,0,474,462,3,0,0,465
"094","Isernia",20,494,0,0,0,494,441,5,0,0,446
"094","Isernia",21,472,1,0,0,473,461,7,0,0,468
"094","Isernia",22,513,4,0,0,517,458,17,0,0,475
"094","Isernia",23,536,10,0,0,546,474,34,0,0,508
"094","Isernia",24,517,9,0,1,527,475,54,0,0,529
"094","Isernia",25,536,19,0,1,556,473,66,0,0,539
"094","Isernia",26,522,40,0,0,562,450,78,2,0,530
"094","Isernia",27,557,38,0,0,595,371,129,0,0,500
"094","Isernia",28,503,62,0,0,565,377,134,1,0,512
"094","Isernia",29,456,85,2,0,543,337,194,1,0,532
"094","Isernia",30,481,115,0,2,598,350,221,2,0,573
"094","Isernia",31,405,158,0,0,563,293,269,4,0,566
"094","Isernia",32,404,188,0,0,592,265,275,5,1,546
"094","Isernia",33,359,212,3,0,574,238,312,3,1,554
"094","Isernia",34,335,242,2,2,581,195,347,6,2,550
"094","Isernia",35,342,300,4,0,646,201,387,7,1,596
"094","Isernia",36,293,322,5,0,620,192,370,5,2,569
"094","Isernia",37,293,337,4,0,634,161,449,7,6,623
"094","Isernia",38,254,367,7,1,629,124,451,13,5,593
"094","Isernia",39,198,405,1,0,604,128,444,11,1,584
"094","Isernia",40,208,418,7,1,634,127,501,12,2,642
"094","Isernia",41,187,390,9,0,586,92,491,15,8,606
"094","Isernia",42,147,410,6,2,565,101,523,19,6,649
"094","Isernia",43,186,459,11,1,657,96,546,22,9,673
"094","Isernia",44,170,482,10,0,662,100,549,17,11,677
"094","Isernia",45,155,478,18,3,654,99,512,17,18,646
"094","Isernia",46,140,494,13,2,649,93,533,17,25,668
"094","Isernia",47,128,549,9,3,689,90,563,13,22,688
"094","Isernia",48,127,502,11,6,646,78,540,13,14,645
"094","Isernia",49,114,479,11,8,612,74,534,13,22,643
"094","Isernia",50,111,491,15,5,622,64,506,9,30,609
"094","Isernia",51,103,509,14,6,632,80,529,14,32,655
"094","Isernia",52,94,538,15,3,650,73,514,16,43,646
"094","Isernia",53,96,513,11,8,628,54,493,12,32,591
"094","Isernia",54,83,521,16,5,625,68,481,15,45,609
"094","Isernia",55,68,554,13,4,639,54,477,17,41,589
"094","Isernia",56,74,505,13,7,599,50,496,16,44,606
"094","Isernia",57,69,530,9,9,617,60,475,9,63,607
"094","Isernia",58,49,504,15,9,577,53,482,12,56,603
"094","Isernia",59,48,496,7,12,563,56,443,11,59,569
"094","Isernia",60,34,467,7,9,517,38,419,11,67,535
"094","Isernia",61,60,489,11,13,573,36,442,8,76,562
"094","Isernia",62,47,518,13,18,596,40,445,13,86,584
"094","Isernia",63,47,481,10,32,570,45,444,10,84,583
"094","Isernia",64,47,491,10,21,569,54,431,8,81,574
"094","Isernia",65,39,467,8,16,530,31,357,7,89,484
"094","Isernia",66,35,350,4,16,405,28,292,4,81,405
"094","Isernia",67,29,333,5,14,381,27,278,7,98,410
"094","Isernia",68,25,288,4,16,333,26,253,7,93,379
"094","Isernia",69,24,328,5,22,379,26,231,8,98,363
"094","Isernia",70,22,317,3,17,359,36,272,5,113,426
"094","Isernia",71,32,355,7,35,429,34,302,5,152,493
"094","Isernia",72,32,360,6,31,429,33,317,7,152,509
"094","Isernia",73,21,332,2,29,384,31,273,2,163,469
"094","Isernia",74,25,330,1,31,387,41,244,6,177,468
"094","Isernia",75,17,330,3,36,386,28,273,3,202,506
"094","Isernia",76,25,288,3,42,358,30,207,15,201,453
"094","Isernia",77,26,304,6,50,386,39,224,5,214,482
"094","Isernia",78,20,294,2,41,357,44,209,4,239,496
"094","Isernia",79,12,244,1,42,299,30,197,4,229,460
"094","Isernia",80,17,271,2,57,347,26,186,6,232,450
"094","Isernia",81,18,227,1,60,306,35,173,3,281,492
"094","Isernia",82,10,210,0,58,278,26,134,5,246,411
"094","Isernia",83,11,172,2,61,246,31,100,3,240,374
"094","Isernia",84,14,172,0,60,246,26,91,2,254,373
"094","Isernia",85,4,140,2,42,188,33,75,1,248,357
"094","Isernia",86,6,115,0,59,180,19,60,2,255,336
"094","Isernia",87,9,77,0,46,132,17,60,0,217,294
"094","Isernia",88,6,83,0,48,137,24,39,0,199,262
"094","Isernia",89,3,71,0,53,127,24,30,1,213,268
"094","Isernia",90,3,57,1,40,101,20,23,2,176,221
"094","Isernia",91,5,37,0,33,75,6,25,0,124,155
"094","Isernia",92,1,20,0,19,40,8,8,0,69,85
"094","Isernia",93,2,6,0,14,22,4,3,0,55,62
"094","Isernia",94,0,7,0,14,21,6,2,0,43,51
"094","Isernia",95,1,8,0,15,24,2,4,0,49,55
"094","Isernia",96,0,6,0,10,16,3,1,0,47,51
"094","Isernia",97,0,5,0,12,17,3,1,0,33,37
"094","Isernia",98,0,5,0,9,14,4,4,0,27,35
"094","Isernia",99,0,2,0,7,9,2,1,0,16,19
"094","Isernia",100,0,4,0,10,14,2,1,0,15,18
"095","Oristano",0,595,0,0,0,595,507,0,0,0,507
"095","Oristano",1,589,0,0,0,589,584,0,0,0,584
"095","Oristano",2,597,0,0,0,597,521,0,0,0,521
"095","Oristano",3,612,0,0,0,612,537,0,0,0,537
"095","Oristano",4,580,0,0,0,580,597,0,0,0,597
"095","Oristano",5,643,0,0,0,643,533,0,0,0,533
"095","Oristano",6,630,0,0,0,630,593,0,0,0,593
"095","Oristano",7,615,0,0,0,615,605,0,0,0,605
"095","Oristano",8,679,0,0,0,679,600,0,0,0,600
"095","Oristano",9,629,0,0,0,629,609,0,0,0,609
"095","Oristano",10,655,0,0,0,655,656,0,0,0,656
"095","Oristano",11,706,0,0,0,706,640,0,0,0,640
"095","Oristano",12,716,0,0,0,716,672,0,0,0,672
"095","Oristano",13,695,0,0,0,695,637,0,0,0,637
"095","Oristano",14,742,0,0,0,742,645,0,0,0,645
"095","Oristano",15,712,0,0,0,712,660,0,0,0,660
"095","Oristano",16,766,1,0,0,767,677,0,0,0,677
"095","Oristano",17,743,1,0,0,744,709,1,0,0,710
"095","Oristano",18,820,0,0,0,820,704,0,0,0,704
"095","Oristano",19,824,0,0,0,824,799,1,0,0,800
"095","Oristano",20,925,0,0,0,925,785,6,0,0,791
"095","Oristano",21,866,3,0,0,869,863,10,0,0,873
"095","Oristano",22,888,3,0,0,891,804,20,0,0,824
"095","Oristano",23,866,10,0,0,876,792,40,0,0,832
"095","Oristano",24,971,5,0,0,976,840,57,0,0,897
"095","Oristano",25,868,15,0,0,883,826,72,0,0,898
"095","Oristano",26,936,31,0,0,967,775,117,0,0,892
"095","Oristano",27,960,51,0,0,1011,848,135,1,0,984
"095","Oristano",28,974,69,0,0,1043,785,189,2,0,976
"095","Oristano",29,978,110,1,0,1089,727,251,3,1,982
"095","Oristano",30,870,147,1,0,1018,702,275,5,0,982
"095","Oristano",31,833,171,0,0,1004,644,343,6,0,993
"095","Oristano",32,812,222,0,0,1034,603,429,1,2,1035
"095","Oristano",33,857,292,2,0,1151,555,491,2,4,1052
"095","Oristano",34,782,359,4,0,1145,521,561,6,6,1094
"095","Oristano",35,735,408,7,1,1151,466,590,8,5,1069
"095","Oristano",36,702,443,6,0,1151,478,674,19,3,1174
"095","Oristano",37,680,570,8,1,1259,418,711,27,4,1160
"095","Oristano",38,584,572,7,1,1164,373,759,23,6,1161
"095","Oristano",39,561,640,12,2,1215,374,770,20,9,1173
"095","Oristano",40,510,709,11,1,1231,325,885,30,15,1255
"095","Oristano",41,501,723,16,1,1241,277,837,22,10,1146
"095","Oristano",42,484,768,15,3,1270,286,897,25,15,1223
"095","Oristano",43,383,762,24,1,1170,279,898,40,9,1226
"095","Oristano",44,425,829,25,2,1281,255,964,32,17,1268
"095","Oristano",45,363,882,33,0,1278,253,1016,42,22,1333
"095","Oristano",46,360,912,21,8,1301,226,988,44,27,1285
"095","Oristano",47,327,917,27,7,1278,223,1065,37,28,1353
"095","Oristano",48,308,880,33,8,1229,216,1061,41,22,1340
"095","Oristano",49,284,962,29,7,1282,200,1030,22,30,1282
"095","Oristano",50,276,936,31,4,1247,185,997,32,34,1248
"095","Oristano",51,245,919,27,11,1202,171,984,30,42,1227
"095","Oristano",52,259,921,29,4,1213,127,941,26,63,1157
"095","Oristano",53,227,865,32,16,1140,141,955,31,55,1182
"095","Oristano",54,215,950,20,12,1197,161,953,30,69,1213
"095","Oristano",55,223,882,21,14,1140,167,896,27,71,1161
"095","Oristano",56,174,944,16,11,1145,137,913,31,74,1155
"095","Oristano",57,179,959,26,10,1174,132,889,23,85,1129
"095","Oristano",58,183,916,22,19,1140,123,897,25,94,1139
"095","Oristano",59,171,877,19,21,1088,124,867,19,91,1101
"095","Oristano",60,165,902,24,31,1122,136,802,19,123,1080
"095","Oristano",61,180,917,30,38,1165,136,841,20,109,1106
"095","Oristano",62,164,882,21,23,1090,125,809,23,131,1088
"095","Oristano",63,149,869,16,34,1068,141,799,19,135,1094
"095","Oristano",64,151,836,20,29,1036,123,806,22,146,1097
"095","Oristano",65,126,828,19,32,1005,127,696,16,141,980
"095","Oristano",66,147,758,15,36,956,113,619,12,160,904
"095","Oristano",67,146,798,18,46,1008,141,706,8,215,1070
"095","Oristano",68,114,709,14,36,873,130,682,11,218,1041
"095","Oristano",69,106,717,13,37,873,127,623,11,229,990
"095","Oristano",70,117,655,11,37,820,108,540,15,223,886
"095","Oristano",71,143,709,17,64,933,163,628,9,292,1092
"095","Oristano",72,138,727,18,62,945,151,532,9,313,1005
"095","Oristano",73,101,607,13,56,777,136,496,11,277,920
"095","Oristano",74,106,572,8,49,735,140,432,5,304,881
"095","Oristano",75,107,541,6,54,708,141,404,12,342,899
"095","Oristano",76,100,479,5,42,626,131,335,9,372,847
"095","Oristano",77,99,500,8,77,684,129,353,6,364,852
"095","Oristano",78,96,509,3,75,683,120,312,5,475,912
"095","Oristano",79,84,443,5,66,598,149,265,2,367,783
"095","Oristano",80,62,384,5,71,522,118,235,5,424,782
"095","Oristano",81,76,345,1,92,514,156,181,8,421,766
"095","Oristano",82,62,343,2,70,477,122,166,2,437,727
"095","Oristano",83,60,294,4,66,424,138,155,4,406,703
"095","Oristano",84,41,232,0,65,338,109,115,3,374,601
"095","Oristano",85,39,218,2,71,330,107,113,2,361,583
"095","Oristano",86,35,174,2,84,295,97,82,2,332,513
"095","Oristano",87,32,143,0,76,251,85,54,1,334,474
"095","Oristano",88,20,119,1,57,197,56,49,2,309,416
"095","Oristano",89,16,101,0,58,175,65,26,1,282,374
"095","Oristano",90,12,67,0,39,118,46,20,0,190,256
"095","Oristano",91,13,51,0,43,107,36,18,1,186,241
"095","Oristano",92,12,47,1,27,87,27,9,1,140,177
"095","Oristano",93,5,12,0,20,37,10,3,0,79,92
"095","Oristano",94,5,14,0,18,37,14,1,1,59,75
"095","Oristano",95,4,13,1,12,30,11,2,0,58,71
"095","Oristano",96,1,15,0,16,32,10,1,1,52,64
"095","Oristano",97,2,6,0,8,16,6,1,0,37,44
"095","Oristano",98,0,5,0,17,22,8,2,0,25,35
"095","Oristano",99,1,5,0,7,13,5,0,0,16,21
"095","Oristano",100,2,2,0,3,7,6,0,0,25,31
"096","Biella",0,619,0,0,0,619,623,0,0,0,623
"096","Biella",1,668,0,0,0,668,644,0,0,0,644
"096","Biella",2,673,0,0,0,673,708,0,0,0,708
"096","Biella",3,707,0,0,0,707,678,0,0,0,678
"096","Biella",4,744,0,0,0,744,691,0,0,0,691
"096","Biella",5,757,0,0,0,757,703,0,0,0,703
"096","Biella",6,760,0,0,0,760,698,0,0,0,698
"096","Biella",7,744,0,0,0,744,678,0,0,0,678
"096","Biella",8,773,0,0,0,773,728,0,0,0,728
"096","Biella",9,750,0,0,0,750,699,0,0,0,699
"096","Biella",10,718,0,0,0,718,737,0,0,0,737
"096","Biella",11,821,0,0,0,821,754,0,0,0,754
"096","Biella",12,772,0,0,0,772,706,0,0,0,706
"096","Biella",13,753,0,0,0,753,724,0,0,0,724
"096","Biella",14,772,0,0,0,772,704,0,0,0,704
"096","Biella",15,732,0,0,0,732,729,0,0,0,729
"096","Biella",16,740,0,0,0,740,756,0,0,0,756
"096","Biella",17,718,0,0,0,718,750,0,0,0,750
"096","Biella",18,770,0,0,0,770,761,4,0,0,765
"096","Biella",19,808,1,0,0,809,765,4,0,0,769
"096","Biella",20,841,3,0,0,844,743,13,0,1,757
"096","Biella",21,816,3,0,0,819,745,21,0,0,766
"096","Biella",22,755,5,0,0,760,653,38,0,0,691
"096","Biella",23,783,18,1,0,802,706,64,0,0,770
"096","Biella",24,686,21,0,0,707,604,81,0,0,685
"096","Biella",25,760,46,0,0,806,589,127,1,0,717
"096","Biella",26,735,70,3,0,808,605,182,1,1,789
"096","Biella",27,769,82,0,1,852,581,193,3,1,778
"096","Biella",28,716,108,1,0,825,534,212,1,0,747
"096","Biella",29,697,174,0,0,871,560,322,5,0,887
"096","Biella",30,655,183,2,0,840,497,386,5,0,888
"096","Biella",31,640,258,5,0,903,553,443,15,0,1011
"096","Biella",32,652,291,5,0,948,481,445,9,0,935
"096","Biella",33,699,396,6,1,1102,500,563,18,6,1087
"096","Biella",34,631,461,12,0,1104,466,611,24,1,1102
"096","Biella",35,684,486,12,1,1183,445,673,29,7,1154
"096","Biella",36,625,559,14,0,1198,471,730,48,8,1257
"096","Biella",37,668,624,22,3,1317,444,825,52,7,1328
"096","Biella",38,659,639,25,3,1326,376,823,58,5,1262
"096","Biella",39,578,724,32,2,1336,384,891,75,6,1356
"096","Biella",40,551,793,43,3,1390,349,979,76,10,1414
"096","Biella",41,538,840,56,1,1435,332,982,83,19,1416
"096","Biella",42,508,889,58,3,1458,293,985,89,16,1383
"096","Biella",43,459,897,68,3,1427,313,1056,113,14,1496
"096","Biella",44,438,956,70,6,1470,302,1041,124,36,1503
"096","Biella",45,412,992,74,7,1485,265,1029,98,17,1409
"096","Biella",46,402,1019,95,11,1527,233,1145,124,31,1533
"096","Biella",47,375,1065,115,2,1557,244,1153,131,31,1559
"096","Biella",48,327,1029,91,5,1452,182,1059,111,25,1377
"096","Biella",49,310,955,98,12,1375,186,1012,111,35,1344
"096","Biella",50,260,1011,106,7,1384,162,1045,127,51,1385
"096","Biella",51,249,948,84,13,1294,154,1075,94,42,1365
"096","Biella",52,221,910,91,17,1239,146,960,89,68,1263
"096","Biella",53,198,898,83,17,1196,118,956,101,57,1232
"096","Biella",54,196,938,91,20,1245,127,968,106,70,1271
"096","Biella",55,189,997,89,16,1291,129,939,103,74,1245
"096","Biella",56,162,958,69,8,1197,132,996,107,85,1320
"096","Biella",57,163,954,68,17,1202,108,1005,94,93,1300
"096","Biella",58,133,961,61,19,1174,107,956,71,100,1234
"096","Biella",59,139,975,62,29,1205,105,964,81,115,1265
"096","Biella",60,124,962,56,32,1174,82,971,88,129,1270
"096","Biella",61,116,963,62,47,1188,96,1090,57,153,1396
"096","Biella",62,139,1065,57,46,1307,84,990,67,150,1291
"096","Biella",63,121,1081,67,38,1307,103,1049,61,196,1409
"096","Biella",64,119,1029,56,37,1241,78,984,54,211,1327
"096","Biella",65,100,971,48,65,1184,74,954,70,215,1313
"096","Biella",66,86,801,43,55,985,67,704,55,187,1013
"096","Biella",67,101,850,41,59,1051,78,789,30,218,1115
"096","Biella",68,91,825,34,48,998,58,760,43,255,1116
"096","Biella",69,92,855,21,63,1031,59,792,43,299,1193
"096","Biella",70,109,844,37,83,1073,88,777,50,324,1239
"096","Biella",71,93,968,30,88,1179,86,857,56,357,1356
"096","Biella",72,89,890,22,105,1106,82,782,54,415,1333
"096","Biella",73,102,814,28,99,1043,91,740,28,445,1304
"096","Biella",74,73,779,30,97,979,87,619,33,441,1180
"096","Biella",75,71,711,15,101,898,72,534,27,480,1113
"096","Biella",76,57,696,14,97,864,82,553,22,540,1197
"096","Biella",77,50,648,16,100,814,86,466,24,534,1110
"096","Biella",78,54,548,9,101,712,85,414,16,567,1082
"096","Biella",79,63,528,13,117,721,78,374,18,637,1107
"096","Biella",80,47,531,9,126,713,84,339,19,639,1081
"096","Biella",81,33,507,4,113,657,85,325,19,674,1103
"096","Biella",82,37,387,2,104,530,86,246,6,667,1005
"096","Biella",83,32,363,5,104,504,77,205,12,640,934
"096","Biella",84,25,274,7,111,417,78,172,16,644,910
"096","Biella",85,33,257,6,104,400,79,149,17,634,879
"096","Biella",86,17,203,5,84,309,73,112,12,528,725
"096","Biella",87,19,145,3,83,250,78,81,8,504,671
"096","Biella",88,10,135,1,79,225,70,64,5,471,610
"096","Biella",89,9,114,4,59,186,50,52,6,413,521
"096","Biella",90,7,90,4,62,163,49,28,3,393,473
"096","Biella",91,4,73,2,39,118,27,22,2,338,389
"096","Biella",92,7,38,0,30,75,19,15,0,172,206
"096","Biella",93,3,10,0,15,28,14,6,0,112,132
"096","Biella",94,0,7,0,16,23,11,2,0,87,100
"096","Biella",95,3,8,0,16,27,12,1,0,80,93
"096","Biella",96,1,6,0,15,22,11,2,1,101,115
"096","Biella",97,0,8,0,9,17,6,2,0,71,79
"096","Biella",98,0,1,0,8,9,8,1,0,45,54
"096","Biella",99,0,2,0,4,6,6,0,0,35,41
"096","Biella",100,1,1,0,7,9,12,0,0,49,61
"097","Lecco",0,1598,0,0,0,1598,1579,0,0,0,1579
"097","Lecco",1,1725,0,0,0,1725,1625,0,0,0,1625
"097","Lecco",2,1773,0,0,0,1773,1556,0,0,0,1556
"097","Lecco",3,1724,0,0,0,1724,1680,0,0,0,1680
"097","Lecco",4,1675,0,0,0,1675,1653,0,0,0,1653
"097","Lecco",5,1615,0,0,0,1615,1640,0,0,0,1640
"097","Lecco",6,1711,0,0,0,1711,1622,0,0,0,1622
"097","Lecco",7,1591,0,0,0,1591,1585,0,0,0,1585
"097","Lecco",8,1573,0,0,0,1573,1590,0,0,0,1590
"097","Lecco",9,1612,0,0,0,1612,1677,0,0,0,1677
"097","Lecco",10,1632,0,0,0,1632,1602,0,0,0,1602
"097","Lecco",11,1675,0,0,0,1675,1612,0,0,0,1612
"097","Lecco",12,1673,0,0,0,1673,1554,0,0,0,1554
"097","Lecco",13,1627,0,0,0,1627,1483,0,0,0,1483
"097","Lecco",14,1609,0,0,0,1609,1569,0,0,0,1569
"097","Lecco",15,1685,0,0,0,1685,1492,0,0,0,1492
"097","Lecco",16,1574,0,0,0,1574,1510,0,0,0,1510
"097","Lecco",17,1583,0,0,0,1583,1455,1,0,0,1456
"097","Lecco",18,1558,0,0,0,1558,1566,4,0,0,1570
"097","Lecco",19,1649,0,0,0,1649,1517,18,0,0,1535
"097","Lecco",20,1629,2,0,0,1631,1502,49,0,0,1551
"097","Lecco",21,1622,4,0,0,1626,1492,59,0,0,1551
"097","Lecco",22,1721,8,0,0,1729,1487,97,0,1,1585
"097","Lecco",23,1692,30,0,0,1722,1505,155,0,0,1660
"097","Lecco",24,1603,48,0,0,1651,1410,217,1,0,1628
"097","Lecco",25,1674,62,0,0,1736,1271,279,1,0,1551
"097","Lecco",26,1576,106,1,1,1684,1323,405,0,1,1729
"097","Lecco",27,1575,189,2,1,1767,1164,532,2,0,1698
"097","Lecco",28,1504,262,1,0,1767,1136,685,6,1,1828
"097","Lecco",29,1551,418,1,0,1970,1041,775,9,0,1825
"097","Lecco",30,1542,542,5,1,2090,1000,906,5,3,1914
"097","Lecco",31,1355,577,2,0,1934,849,1025,9,3,1886
"097","Lecco",32,1352,733,10,0,2095,870,1105,11,7,1993
"097","Lecco",33,1288,901,2,2,2193,780,1354,20,6,2160
"097","Lecco",34,1235,1088,9,2,2334,768,1525,30,2,2325
"097","Lecco",35,1280,1213,18,1,2512,760,1549,35,3,2347
"097","Lecco",36,1237,1402,26,2,2667,670,1695,50,12,2427
"097","Lecco",37,1238,1481,21,4,2744,743,1803,63,7,2616
"097","Lecco",38,1059,1647,49,2,2757,648,1837,78,14,2577
"097","Lecco",39,1015,1652,44,3,2714,580,1967,72,11,2630
"097","Lecco",40,1025,1666,49,2,2742,594,1926,92,20,2632
"097","Lecco",41,874,1813,56,4,2747,552,1946,91,23,2612
"097","Lecco",42,906,1931,64,4,2905,537,2030,96,12,2675
"097","Lecco",43,863,1908,84,3,2858,528,2079,89,20,2716
"097","Lecco",44,797,1946,75,10,2828,485,2151,118,31,2785
"097","Lecco",45,766,2169,92,6,3033,443,2253,117,35,2848
"097","Lecco",46,693,2074,103,8,2878,450,2211,128,54,2843
"097","Lecco",47,668,2175,99,14,2956,382,2142,109,40,2673
"097","Lecco",48,560,2025,97,12,2694,375,2058,123,53,2609
"097","Lecco",49,472,1994,103,32,2601,370,1937,102,70,2479
"097","Lecco",50,423,1911,103,11,2448,334,1983,131,74,2522
"097","Lecco",51,408,1919,86,16,2429,353,1868,119,86,2426
"097","Lecco",52,391,1893,91,12,2387,315,1882,102,66,2365
"097","Lecco",53,361,1803,96,21,2281,244,1810,115,87,2256
"097","Lecco",54,323,1781,82,16,2202,279,1759,93,90,2221
"097","Lecco",55,293,1897,96,28,2314,262,1788,79,96,2225
"097","Lecco",56,318,1771,75,27,2191,242,1728,77,127,2174
"097","Lecco",57,268,1748,55,34,2105,239,1672,70,140,2121
"097","Lecco",58,264,1711,75,30,2080,207,1680,84,149,2120
"097","Lecco",59,236,1718,68,50,2072,184,1642,70,154,2050
"097","Lecco",60,230,1712,60,34,2036,220,1724,69,189,2202
"097","Lecco",61,263,1757,61,54,2135,211,1739,60,233,2243
"097","Lecco",62,267,1805,53,55,2180,212,1740,62,262,2276
"097","Lecco",63,217,1820,60,64,2161,204,1731,57,269,2261
"097","Lecco",64,203,1761,58,67,2089,187,1638,55,317,2197
"097","Lecco",65,182,1780,48,81,2091,183,1579,49,347,2158
"097","Lecco",66,156,1388,37,68,1649,129,1219,36,303,1687
"097","Lecco",67,161,1471,29,78,1739,129,1253,34,371,1787
"097","Lecco",68,134,1386,33,66,1619,122,1253,43,343,1761
"097","Lecco",69,153,1384,30,77,1644,156,1240,34,417,1847
"097","Lecco",70,182,1422,27,115,1746,140,1227,27,468,1862
"097","Lecco",71,174,1526,23,120,1843,180,1245,27,530,1982
"097","Lecco",72,166,1456,20,116,1758,164,1155,28,616,1963
"097","Lecco",73,132,1412,17,105,1666,172,1087,28,658,1945
"097","Lecco",74,120,1220,15,123,1478,157,933,12,642,1744
"097","Lecco",75,118,1012,13,138,1281,165,796,18,652,1631
"097","Lecco",76,105,980,6,132,1223,152,742,21,756,1671
"097","Lecco",77,96,942,16,144,1198,156,642,9,715,1522
"097","Lecco",78,91,849,11,142,1093,166,582,12,774,1534
"097","Lecco",79,83,785,12,121,1001,169,530,6,852,1557
"097","Lecco",80,76,701,13,127,917,140,445,17,757,1359
"097","Lecco",81,72,685,5,146,908,170,383,9,821,1383
"097","Lecco",82,67,557,4,138,766,147,294,8,840,1289
"097","Lecco",83,54,479,3,137,673,152,266,6,803,1227
"097","Lecco",84,49,430,3,124,606,142,215,12,810,1179
"097","Lecco",85,39,354,3,123,519,133,154,4,760,1051
"097","Lecco",86,31,277,0,116,424,116,125,3,682,926
"097","Lecco",87,15,242,7,99,363,135,88,10,672,905
"097","Lecco",88,16,195,2,110,323,94,83,3,653,833
"097","Lecco",89,4,127,2,91,224,97,32,2,513,644
"097","Lecco",90,14,87,0,78,179,79,30,1,492,602
"097","Lecco",91,8,72,0,41,121,66,23,1,388,478
"097","Lecco",92,4,40,0,31,75,34,15,1,200,250
"097","Lecco",93,3,15,0,13,31,14,4,0,127,145
"097","Lecco",94,1,15,0,14,30,21,5,0,126,152
"097","Lecco",95,2,10,0,16,28,14,1,0,119,134
"097","Lecco",96,1,12,0,14,27,19,2,0,124,145
"097","Lecco",97,1,5,0,17,23,20,2,0,107,129
"097","Lecco",98,0,1,0,11,12,10,1,1,58,70
"097","Lecco",99,0,2,0,11,13,13,0,0,42,55
"097","Lecco",100,0,1,0,12,13,13,0,0,64,77
"098","Lodi",0,1103,0,0,0,1103,1024,0,0,0,1024
"098","Lodi",1,1107,0,0,0,1107,1096,0,0,0,1096
"098","Lodi",2,1220,0,0,0,1220,1140,0,0,0,1140
"098","Lodi",3,1161,0,0,0,1161,1097,0,0,0,1097
"098","Lodi",4,1153,0,0,0,1153,1068,0,0,0,1068
"098","Lodi",5,1144,0,0,0,1144,1087,0,0,0,1087
"098","Lodi",6,1146,0,0,0,1146,1051,0,0,0,1051
"098","Lodi",7,1093,0,0,0,1093,1118,0,0,0,1118
"098","Lodi",8,1096,0,0,0,1096,1033,0,0,0,1033
"098","Lodi",9,985,0,0,0,985,1007,0,0,0,1007
"098","Lodi",10,1087,0,0,0,1087,999,0,0,0,999
"098","Lodi",11,1072,0,0,0,1072,1021,0,0,0,1021
"098","Lodi",12,1075,0,0,0,1075,1010,0,0,0,1010
"098","Lodi",13,1042,0,0,0,1042,934,0,0,0,934
"098","Lodi",14,1039,0,0,0,1039,985,0,0,0,985
"098","Lodi",15,1042,0,0,0,1042,987,0,0,0,987
"098","Lodi",16,993,0,0,0,993,984,0,0,0,984
"098","Lodi",17,986,0,0,0,986,991,3,0,0,994
"098","Lodi",18,1028,0,0,0,1028,919,5,0,0,924
"098","Lodi",19,1104,1,0,0,1105,963,15,0,0,978
"098","Lodi",20,1022,4,1,0,1027,1037,43,1,0,1081
"098","Lodi",21,1070,10,1,0,1081,974,71,0,0,1045
"098","Lodi",22,1090,13,0,0,1103,971,102,0,0,1073
"098","Lodi",23,1086,22,0,0,1108,927,156,1,0,1084
"098","Lodi",24,1020,40,0,0,1060,940,184,1,0,1125
"098","Lodi",25,1100,74,0,0,1174,885,277,3,1,1166
"098","Lodi",26,1016,119,1,1,1137,839,307,1,0,1147
"098","Lodi",27,1083,154,0,0,1237,827,426,2,0,1255
"098","Lodi",28,1048,228,3,0,1279,732,502,7,2,1243
"098","Lodi",29,1033,302,0,0,1335,719,592,9,1,1321
"098","Lodi",30,991,381,4,0,1376,680,704,4,2,1390
"098","Lodi",31,928,503,4,2,1437,613,827,12,1,1453
"098","Lodi",32,952,625,2,0,1579,619,866,22,3,1510
"098","Lodi",33,900,676,6,0,1582,551,965,26,5,1547
"098","Lodi",34,926,804,9,0,1739,572,1038,27,7,1644
"098","Lodi",35,891,911,18,1,1821,508,1138,27,4,1677
"098","Lodi",36,895,981,20,2,1898,546,1268,48,10,1872
"098","Lodi",37,825,1125,19,1,1970,512,1334,48,13,1907
"098","Lodi",38,787,1098,32,1,1918,467,1279,63,8,1817
"098","Lodi",39,696,1230,46,3,1975,460,1274,76,12,1822
"098","Lodi",40,665,1223,41,4,1933,380,1381,69,14,1844
"098","Lodi",41,632,1317,63,4,2016,360,1314,73,23,1770
"098","Lodi",42,591,1298,69,5,1963,361,1460,91,19,1931
"098","Lodi",43,565,1347,62,2,1976,340,1434,105,22,1901
"098","Lodi",44,535,1394,72,4,2005,317,1522,99,25,1963
"098","Lodi",45,509,1436,74,5,2024,276,1475,104,28,1883
"098","Lodi",46,428,1508,98,11,2045,245,1488,108,32,1873
"098","Lodi",47,405,1437,84,10,1936,238,1417,94,31,1780
"098","Lodi",48,368,1372,78,16,1834,245,1367,96,45,1753
"098","Lodi",49,300,1324,75,13,1712,173,1371,96,44,1684
"098","Lodi",50,329,1240,78,13,1660,186,1290,80,50,1606
"098","Lodi",51,252,1239,78,16,1585,186,1252,89,63,1590
"098","Lodi",52,244,1302,64,13,1623,158,1274,67,58,1557
"098","Lodi",53,238,1223,54,24,1539,137,1175,85,70,1467
"098","Lodi",54,194,1206,69,23,1492,157,1142,83,95,1477
"098","Lodi",55,188,1201,44,13,1446,124,1217,67,82,1490
"098","Lodi",56,170,1149,58,21,1398,117,1153,69,98,1437
"098","Lodi",57,172,1129,59,20,1380,103,1157,63,126,1449
"098","Lodi",58,155,1081,50,17,1303,107,1007,47,111,1272
"098","Lodi",59,143,1109,50,26,1328,101,1088,58,122,1369
"098","Lodi",60,147,1064,48,31,1290,97,1017,31,122,1267
"098","Lodi",61,183,1185,47,35,1450,96,1082,47,153,1378
"098","Lodi",62,146,1172,32,39,1389,88,1096,50,205,1439
"098","Lodi",63,134,1221,45,45,1445,83,1079,54,192,1408
"098","Lodi",64,106,1153,34,41,1334,93,1021,41,227,1382
"098","Lodi",65,129,1143,37,55,1364,70,1054,35,234,1393
"098","Lodi",66,96,857,24,39,1016,65,736,26,236,1063
"098","Lodi",67,95,897,21,57,1070,74,774,22,259,1129
"098","Lodi",68,100,847,19,49,1015,78,779,22,287,1166
"098","Lodi",69,114,839,24,68,1045,80,773,22,312,1187
"098","Lodi",70,103,878,18,72,1071,89,703,25,390,1207
"098","Lodi",71,111,896,18,81,1106,72,764,21,420,1277
"098","Lodi",72,130,852,20,89,1091,81,695,22,500,1298
"098","Lodi",73,96,779,17,101,993,72,612,25,516,1225
"098","Lodi",74,85,749,12,96,942,84,587,19,472,1162
"098","Lodi",75,69,641,9,88,807,75,497,9,514,1095
"098","Lodi",76,86,646,9,103,844,82,441,8,532,1063
"098","Lodi",77,79,566,9,102,756,83,350,10,564,1007
"098","Lodi",78,78,494,6,88,666,73,303,8,558,942
"098","Lodi",79,51,467,3,105,626,68,243,14,602,927
"098","Lodi",80,61,386,4,96,547,75,289,5,601,970
"098","Lodi",81,45,397,3,100,545,81,207,14,608,910
"098","Lodi",82,41,285,1,98,425,73,184,1,589,847
"098","Lodi",83,22,275,2,101,400,77,155,4,515,751
"098","Lodi",84,27,251,2,71,351,66,124,5,526,721
"098","Lodi",85,24,203,0,87,314,60,73,4,471,608
"098","Lodi",86,21,153,0,76,250,60,64,3,448,575
"098","Lodi",87,22,129,2,67,220,49,46,4,434,533
"098","Lodi",88,8,108,1,75,192,55,34,5,385,479
"098","Lodi",89,8,79,0,57,144,36,35,4,368,443
"098","Lodi",90,9,56,0,37,102,38,18,2,299,357
"098","Lodi",91,4,35,0,48,87,30,13,2,261,306
"098","Lodi",92,5,23,0,21,49,16,5,0,125,146
"098","Lodi",93,3,5,0,5,13,14,3,0,90,107
"098","Lodi",94,0,7,0,4,11,5,4,0,70,79
"098","Lodi",95,1,5,2,6,14,7,1,1,60,69
"098","Lodi",96,1,5,0,4,10,9,2,0,60,71
"098","Lodi",97,0,4,0,3,7,7,0,0,42,49
"098","Lodi",98,1,0,0,4,5,6,0,0,30,36
"098","Lodi",99,0,1,0,3,4,3,0,0,20,23
"098","Lodi",100,0,1,0,2,3,4,0,1,23,28
"099","Rimini",0,1455,0,0,0,1455,1445,0,0,0,1445
"099","Rimini",1,1554,0,0,0,1554,1568,0,0,0,1568
"099","Rimini",2,1535,0,0,0,1535,1506,0,0,0,1506
"099","Rimini",3,1644,0,0,0,1644,1549,0,0,0,1549
"099","Rimini",4,1638,0,0,0,1638,1551,0,0,0,1551
"099","Rimini",5,1584,0,0,0,1584,1464,0,0,0,1464
"099","Rimini",6,1564,0,0,0,1564,1495,0,0,0,1495
"099","Rimini",7,1482,0,0,0,1482,1479,0,0,0,1479
"099","Rimini",8,1466,0,0,0,1466,1446,0,0,0,1446
"099","Rimini",9,1526,0,0,0,1526,1418,0,0,0,1418
"099","Rimini",10,1496,0,0,0,1496,1472,0,0,0,1472
"099","Rimini",11,1545,0,0,0,1545,1454,0,0,0,1454
"099","Rimini",12,1544,0,0,0,1544,1442,0,0,0,1442
"099","Rimini",13,1395,0,0,0,1395,1351,0,0,0,1351
"099","Rimini",14,1392,0,0,0,1392,1411,0,0,0,1411
"099","Rimini",15,1451,0,0,0,1451,1350,0,0,0,1350
"099","Rimini",16,1439,0,0,0,1439,1271,0,0,0,1271
"099","Rimini",17,1438,0,0,0,1438,1354,0,0,0,1354
"099","Rimini",18,1503,0,0,0,1503,1327,3,0,0,1330
"099","Rimini",19,1490,1,0,0,1491,1331,20,0,0,1351
"099","Rimini",20,1507,4,0,0,1511,1354,36,0,0,1390
"099","Rimini",21,1463,3,0,0,1466,1403,59,0,0,1462
"099","Rimini",22,1489,10,0,0,1499,1319,124,0,0,1443
"099","Rimini",23,1478,24,0,1,1503,1281,146,0,0,1427
"099","Rimini",24,1337,50,0,0,1387,1230,197,1,0,1428
"099","Rimini",25,1405,67,0,0,1472,1272,275,1,0,1548
"099","Rimini",26,1455,111,0,0,1566,1261,347,4,2,1614
"099","Rimini",27,1441,184,2,0,1627,1260,432,7,1,1700
"099","Rimini",28,1422,231,2,0,1655,1281,573,7,1,1862
"099","Rimini",29,1522,346,1,0,1869,1219,671,13,2,1905
"099","Rimini",30,1417,440,3,0,1860,1113,733,15,3,1864
"099","Rimini",31,1317,513,5,0,1835,1072,899,24,5,2000
"099","Rimini",32,1292,683,9,1,1985,1008,1003,19,1,2031
"099","Rimini",33,1353,772,9,2,2136,1054,1143,36,3,2236
"099","Rimini",34,1430,907,18,1,2356,992,1272,51,7,2322
"099","Rimini",35,1317,1077,19,0,2413,1095,1414,63,3,2575
"099","Rimini",36,1380,1175,28,1,2584,1018,1573,72,13,2676
"099","Rimini",37,1285,1275,40,2,2602,1004,1613,100,10,2727
"099","Rimini",38,1202,1395,39,1,2637,868,1727,111,17,2723
"099","Rimini",39,1116,1472,46,1,2635,795,1723,116,15,2649
"099","Rimini",40,1089,1602,72,3,2766,817,1796,129,13,2755
"099","Rimini",41,919,1665,83,0,2667,781,1897,130,27,2835
"099","Rimini",42,958,1705,83,4,2750,743,1876,147,17,2783
"099","Rimini",43,865,1765,101,8,2739,705,1936,166,21,2828
"099","Rimini",44,819,1850,111,6,2786,676,1843,142,23,2684
"099","Rimini",45,773,1861,130,12,2776,580,1917,175,50,2722
"099","Rimini",46,716,1833,129,8,2686,560,1905,162,45,2672
"099","Rimini",47,673,2007,114,12,2806,555,2058,182,35,2830
"099","Rimini",48,554,1769,136,15,2474,524,1862,210,42,2638
"099","Rimini",49,501,1784,159,11,2455,437,1855,201,51,2544
"099","Rimini",50,467,1712,117,8,2304,418,1863,169,58,2508
"099","Rimini",51,407,1680,130,11,2228,398,1757,162,72,2389
"099","Rimini",52,385,1723,108,19,2235,363,1777,184,71,2395
"099","Rimini",53,324,1627,115,23,2089,399,1660,169,99,2327
"099","Rimini",54,320,1620,117,29,2086,348,1641,134,72,2195
"099","Rimini",55,333,1603,122,28,2086,298,1601,140,104,2143
"099","Rimini",56,276,1561,104,16,1957,289,1548,139,119,2095
"099","Rimini",57,243,1507,109,21,1880,261,1585,113,129,2088
"099","Rimini",58,241,1421,93,30,1785,241,1495,128,126,1990
"099","Rimini",59,205,1477,74,33,1789,224,1519,116,141,2000
"099","Rimini",60,163,1513,103,44,1823,213,1554,123,159,2049
"099","Rimini",61,170,1600,77,47,1894,173,1544,115,202,2034
"099","Rimini",62,181,1587,70,53,1891,178,1567,109,219,2073
"099","Rimini",63,171,1710,57,68,2006,174,1635,81,260,2150
"099","Rimini",64,160,1652,84,47,1943,139,1606,89,285,2119
"099","Rimini",65,162,1610,72,63,1907,170,1584,94,296,2144
"099","Rimini",66,142,1249,56,54,1501,106,1227,80,289,1702
"099","Rimini",67,113,1297,68,69,1547,130,1244,69,294,1737
"099","Rimini",68,119,1375,53,92,1639,108,1255,54,352,1769
"099","Rimini",69,121,1252,44,70,1487,123,1102,51,354,1630
"099","Rimini",70,123,1287,48,79,1537,85,1110,57,426,1678
"099","Rimini",71,146,1311,38,111,1606,109,1224,48,500,1881
"099","Rimini",72,128,1303,29,118,1578,92,1140,56,472,1760
"099","Rimini",73,123,1352,35,129,1639,106,1127,37,646,1916
"099","Rimini",74,112,1219,25,110,1466,105,962,35,602,1704
"099","Rimini",75,88,1039,25,110,1262,86,811,44,593,1534
"099","Rimini",76,99,1025,21,133,1278,100,824,32,681,1637
"099","Rimini",77,85,992,15,149,1241,109,735,25,745,1614
"099","Rimini",78,80,901,11,144,1136,76,604,26,698,1404
"099","Rimini",79,71,805,18,121,1015,74,530,21,726,1351
"099","Rimini",80,72,814,11,126,1023,94,545,17,771,1427
"099","Rimini",81,62,728,15,159,964,89,472,15,888,1464
"099","Rimini",82,58,642,11,127,838,89,338,17,758,1202
"099","Rimini",83,61,558,12,137,768,80,289,11,798,1178
"099","Rimini",84,42,506,7,138,693,90,265,11,779,1145
"099","Rimini",85,46,448,8,137,639,79,194,5,791,1069
"099","Rimini",86,22,375,2,145,544,77,174,6,749,1006
"099","Rimini",87,28,303,4,120,455,59,122,7,683,871
"099","Rimini",88,26,261,1,142,430,68,101,4,690,863
"099","Rimini",89,8,206,1,117,332,50,67,6,592,715
"099","Rimini",90,8,173,0,105,286,51,48,7,559,665
"099","Rimini",91,9,113,1,90,213,43,37,2,440,522
"099","Rimini",92,3,54,0,44,101,24,15,1,249,289
"099","Rimini",93,4,31,0,23,58,24,5,1,143,173
"099","Rimini",94,3,28,0,25,56,18,6,1,118,143
"099","Rimini",95,0,22,0,30,52,14,5,0,132,151
"099","Rimini",96,2,21,0,27,50,19,2,1,122,144
"099","Rimini",97,1,12,0,24,37,11,0,1,106,118
"099","Rimini",98,0,5,0,14,19,5,0,1,83,89
"099","Rimini",99,0,2,0,10,12,6,0,0,47,53
"099","Rimini",100,0,4,0,14,18,6,1,0,70,77
"100","Prato",0,1158,0,0,0,1158,1141,0,0,0,1141
"100","Prato",1,1280,0,0,0,1280,1135,0,0,0,1135
"100","Prato",2,1287,0,0,0,1287,1174,0,0,0,1174
"100","Prato",3,1306,0,0,0,1306,1236,0,0,0,1236
"100","Prato",4,1306,0,0,0,1306,1233,0,0,0,1233
"100","Prato",5,1286,0,0,0,1286,1236,0,0,0,1236
"100","Prato",6,1285,0,0,0,1285,1164,0,0,0,1164
"100","Prato",7,1171,0,0,0,1171,1161,0,0,0,1161
"100","Prato",8,1228,0,0,0,1228,1134,0,0,0,1134
"100","Prato",9,1204,0,0,0,1204,1108,0,0,0,1108
"100","Prato",10,1157,0,0,0,1157,1096,0,0,0,1096
"100","Prato",11,1115,0,0,0,1115,1141,0,0,0,1141
"100","Prato",12,1113,0,0,0,1113,1046,0,0,0,1046
"100","Prato",13,1081,0,0,0,1081,1071,0,0,0,1071
"100","Prato",14,1074,0,0,0,1074,968,0,0,0,968
"100","Prato",15,1054,0,0,0,1054,951,0,0,0,951
"100","Prato",16,1075,0,0,0,1075,949,0,0,0,949
"100","Prato",17,1025,0,0,0,1025,969,1,0,0,970
"100","Prato",18,1057,0,0,0,1057,1041,3,0,0,1044
"100","Prato",19,1090,0,0,0,1090,1080,10,0,0,1090
"100","Prato",20,1141,1,0,0,1142,1059,23,0,0,1082
"100","Prato",21,1209,4,0,0,1213,1021,47,0,0,1068
"100","Prato",22,1191,12,0,0,1203,1099,66,1,0,1166
"100","Prato",23,1192,16,0,0,1208,1069,116,1,0,1186
"100","Prato",24,1222,27,0,0,1249,1064,155,2,0,1221
"100","Prato",25,1200,56,0,0,1256,1132,208,1,0,1341
"100","Prato",26,1187,85,0,0,1272,1041,237,0,0,1278
"100","Prato",27,1133,125,0,0,1258,1050,312,1,1,1364
"100","Prato",28,1164,170,2,0,1336,950,369,2,0,1321
"100","Prato",29,1168,243,0,1,1412,947,507,5,2,1461
"100","Prato",30,1169,352,1,0,1522,912,599,7,0,1518
"100","Prato",31,1092,429,5,0,1526,877,679,6,0,1562
"100","Prato",32,1068,523,0,0,1591,830,788,9,3,1630
"100","Prato",33,1120,629,12,0,1761,855,846,19,3,1723
"100","Prato",34,1051,689,8,0,1748,741,961,19,3,1724
"100","Prato",35,985,802,11,1,1799,784,1101,26,3,1914
"100","Prato",36,1081,886,13,1,1981,743,1171,38,5,1957
"100","Prato",37,995,1009,20,1,2025,618,1275,51,5,1949
"100","Prato",38,916,1129,37,4,2086,687,1316,76,4,2083
"100","Prato",39,819,1143,46,1,2009,579,1302,61,7,1949
"100","Prato",40,750,1267,40,4,2061,555,1383,85,14,2037
"100","Prato",41,718,1339,48,4,2109,482,1353,80,9,1924
"100","Prato",42,634,1410,56,5,2105,495,1475,74,17,2061
"100","Prato",43,566,1428,61,5,2060,452,1498,74,13,2037
"100","Prato",44,492,1371,72,2,1937,428,1539,89,25,2081
"100","Prato",45,508,1447,82,8,2045,414,1515,89,34,2052
"100","Prato",46,466,1524,86,13,2089,365,1583,102,32,2082
"100","Prato",47,409,1559,74,9,2051,334,1622,117,23,2096
"100","Prato",48,359,1477,86,10,1932,306,1491,107,38,1942
"100","Prato",49,315,1417,79,7,1818,273,1491,114,46,1924
"100","Prato",50,246,1372,79,9,1706,266,1427,127,44,1864
"100","Prato",51,239,1374,74,13,1700,254,1398,103,43,1798
"100","Prato",52,250,1330,73,16,1669,240,1264,101,48,1653
"100","Prato",53,233,1315,76,14,1638,213,1342,109,57,1721
"100","Prato",54,190,1326,72,20,1608,201,1310,112,62,1685
"100","Prato",55,153,1288,56,27,1524,208,1314,91,83,1696
"100","Prato",56,153,1305,56,26,1540,187,1315,83,76,1661
"100","Prato",57,135,1204,85,36,1460,159,1240,98,83,1580
"100","Prato",58,111,1188,56,25,1380,156,1191,73,87,1507
"100","Prato",59,124,1209,42,23,1398,147,1215,81,95,1538
"100","Prato",60,129,1140,47,28,1344,124,1145,59,116,1444
"100","Prato",61,89,1204,50,30,1373,114,1211,65,135,1525
"100","Prato",62,117,1277,44,31,1469,119,1269,62,182,1632
"100","Prato",63,118,1398,37,45,1598,101,1260,61,188,1610
"100","Prato",64,101,1291,41,48,1481,106,1269,63,213,1651
"100","Prato",65,95,1347,38,49,1529,108,1254,54,236,1652
"100","Prato",66,80,1049,22,39,1190,76,972,41,195,1284
"100","Prato",67,58,997,21,52,1128,79,977,43,225,1324
"100","Prato",68,62,1015,24,64,1165,88,943,42,261,1334
"100","Prato",69,84,964,21,54,1123,76,880,39,271,1266
"100","Prato",70,82,952,17,63,1114,72,843,30,334,1279
"100","Prato",71,100,1048,18,69,1235,80,986,31,392,1489
"100","Prato",72,90,1037,19,86,1232,75,831,34,446,1386
"100","Prato",73,80,1084,16,84,1264,96,888,22,493,1499
"100","Prato",74,60,850,10,58,978,76,724,26,468,1294
"100","Prato",75,62,793,8,92,955,57,648,21,426,1152
"100","Prato",76,63,745,13,83,904,56,626,15,487,1184
"100","Prato",77,54,733,12,102,901,63,518,9,486,1076
"100","Prato",78,47,638,7,96,788,64,453,19,495,1031
"100","Prato",79,56,595,6,95,752,59,427,18,534,1038
"100","Prato",80,42,520,8,103,673,38,402,11,562,1013
"100","Prato",81,37,562,5,109,713,58,349,12,604,1023
"100","Prato",82,37,464,5,107,613,50,280,12,592,934
"100","Prato",83,33,410,7,96,546,60,262,7,628,957
"100","Prato",84,18,410,5,113,546,52,205,9,590,856
"100","Prato",85,25,308,2,106,441,48,173,6,576,803
"100","Prato",86,16,279,2,90,387,40,130,6,551,727
"100","Prato",87,12,239,2,116,369,40,124,7,513,684
"100","Prato",88,11,190,1,90,292,50,78,5,488,621
"100","Prato",89,8,143,0,69,220,35,64,2,394,495
"100","Prato",90,10,110,0,109,229,38,38,3,455,534
"100","Prato",91,6,86,1,67,160,19,35,2,347,403
"100","Prato",92,3,39,0,29,71,11,8,1,196,216
"100","Prato",93,1,20,0,19,40,9,5,2,108,124
"100","Prato",94,1,9,0,16,26,7,4,0,82,93
"100","Prato",95,1,19,0,24,44,7,3,1,98,109
"100","Prato",96,1,11,0,20,32,2,5,0,103,110
"100","Prato",97,0,5,0,10,15,1,5,1,74,81
"100","Prato",98,0,11,0,3,14,4,1,0,47,52
"100","Prato",99,0,3,0,6,9,7,1,0,29,37
"100","Prato",100,1,2,0,8,11,5,0,0,35,40
"101","Crotone",0,871,0,0,0,871,799,0,0,0,799
"101","Crotone",1,899,0,0,0,899,909,0,0,0,909
"101","Crotone",2,932,0,0,0,932,801,0,0,0,801
"101","Crotone",3,960,0,0,0,960,855,0,0,0,855
"101","Crotone",4,889,0,0,0,889,822,0,0,0,822
"101","Crotone",5,878,0,0,0,878,926,0,0,0,926
"101","Crotone",6,933,0,0,0,933,908,0,0,0,908
"101","Crotone",7,1000,0,0,0,1000,937,0,0,0,937
"101","Crotone",8,995,0,0,0,995,890,0,0,0,890
"101","Crotone",9,913,0,0,0,913,845,0,0,0,845
"101","Crotone",10,968,0,0,0,968,895,0,0,0,895
"101","Crotone",11,935,0,0,0,935,970,0,0,0,970
"101","Crotone",12,942,0,0,0,942,899,0,0,0,899
"101","Crotone",13,964,0,0,0,964,966,0,0,0,966
"101","Crotone",14,936,0,0,0,936,908,0,0,0,908
"101","Crotone",15,995,0,0,0,995,963,0,0,0,963
"101","Crotone",16,1018,1,0,0,1019,959,0,0,0,959
"101","Crotone",17,1020,0,0,0,1020,1032,0,0,0,1032
"101","Crotone",18,1092,0,0,0,1092,1054,7,0,0,1061
"101","Crotone",19,1171,0,0,0,1171,1092,16,0,0,1108
"101","Crotone",20,1131,2,0,0,1133,1090,34,0,0,1124
"101","Crotone",21,1172,6,0,0,1178,1081,69,0,0,1150
"101","Crotone",22,1196,23,0,0,1219,1041,108,0,0,1149
"101","Crotone",23,1204,33,0,0,1237,1034,144,0,0,1178
"101","Crotone",24,1103,65,0,0,1168,962,238,0,1,1201
"101","Crotone",25,1060,94,0,0,1154,861,298,0,3,1162
"101","Crotone",26,969,123,0,0,1092,803,386,0,0,1189
"101","Crotone",27,977,197,0,0,1174,711,445,3,2,1161
"101","Crotone",28,873,252,1,0,1126,661,476,3,3,1143
"101","Crotone",29,836,337,0,0,1173,559,584,4,3,1150
"101","Crotone",30,738,371,2,0,1111,500,640,6,1,1147
"101","Crotone",31,697,481,1,0,1179,446,694,3,4,1147
"101","Crotone",32,618,555,3,0,1176,412,740,6,0,1158
"101","Crotone",33,579,589,2,1,1171,362,789,7,5,1163
"101","Crotone",34,493,596,3,1,1093,341,860,11,4,1216
"101","Crotone",35,490,723,5,2,1220,304,841,13,12,1170
"101","Crotone",36,434,704,9,2,1149,292,896,11,12,1211
"101","Crotone",37,409,805,1,0,1215,277,942,15,14,1248
"101","Crotone",38,362,811,8,0,1181,257,925,11,12,1205
"101","Crotone",39,346,893,7,0,1246,230,996,12,13,1251
"101","Crotone",40,301,896,13,5,1215,225,1025,18,9,1277
"101","Crotone",41,309,892,15,2,1218,197,968,23,20,1208
"101","Crotone",42,269,915,11,1,1196,226,1054,23,32,1335
"101","Crotone",43,240,910,17,0,1167,175,1050,20,19,1264
"101","Crotone",44,251,940,12,2,1205,194,1071,22,37,1324
"101","Crotone",45,204,970,16,6,1196,180,1046,20,35,1281
"101","Crotone",46,195,982,16,8,1201,181,1039,29,39,1288
"101","Crotone",47,195,1098,18,8,1319,155,1030,27,39,1251
"101","Crotone",48,170,1015,21,3,1209,151,1053,23,25,1252
"101","Crotone",49,126,976,24,7,1133,132,1050,31,39,1252
"101","Crotone",50,162,1051,15,11,1239,159,960,22,61,1202
"101","Crotone",51,115,1012,15,6,1148,126,958,16,53,1153
"101","Crotone",52,122,954,20,7,1103,131,963,22,54,1170
"101","Crotone",53,110,897,15,8,1030,82,907,17,56,1062
"101","Crotone",54,104,1014,25,12,1155,96,849,27,80,1052
"101","Crotone",55,96,937,14,14,1061,103,906,21,66,1096
"101","Crotone",56,84,933,8,12,1037,96,880,18,79,1073
"101","Crotone",57,79,928,16,9,1032,91,860,28,102,1081
"101","Crotone",58,77,876,15,9,977,100,808,15,100,1023
"101","Crotone",59,58,817,15,15,905,80,791,20,95,986
"101","Crotone",60,57,844,7,18,926,81,738,7,104,930
"101","Crotone",61,55,909,12,19,995,74,777,12,138,1001
"101","Crotone",62,70,863,14,21,968,85,843,15,163,1106
"101","Crotone",63,53,887,10,21,971,63,808,16,162,1049
"101","Crotone",64,45,820,9,27,901,69,726,8,184,987
"101","Crotone",65,39,802,14,30,885,65,714,10,185,974
"101","Crotone",66,39,646,8,32,725,62,570,17,170,819
"101","Crotone",67,36,651,10,19,716,52,551,8,171,782
"101","Crotone",68,39,604,3,27,673,52,489,9,184,734
"101","Crotone",69,32,612,4,26,674,51,498,8,206,763
"101","Crotone",70,35,579,8,34,656,58,444,7,231,740
"101","Crotone",71,30,683,4,41,758,62,531,11,311,915
"101","Crotone",72,21,623,5,60,709,62,470,7,273,812
"101","Crotone",73,22,586,4,45,657,52,417,8,295,772
"101","Crotone",74,23,571,7,62,663,50,429,6,331,816
"101","Crotone",75,19,578,5,65,667,52,384,8,342,786
"101","Crotone",76,13,520,1,69,603,51,366,2,372,791
"101","Crotone",77,21,498,3,66,588,45,278,3,394,720
"101","Crotone",78,29,438,0,89,556,32,281,4,356,673
"101","Crotone",79,10,449,4,85,548,52,231,2,377,662
"101","Crotone",80,16,346,1,78,441,44,225,3,393,665
"101","Crotone",81,22,359,0,89,470,50,162,3,380,595
"101","Crotone",82,16,294,0,104,414,34,127,4,314,479
"101","Crotone",83,8,244,1,71,324,27,107,2,331,467
"101","Crotone",84,13,207,1,82,303,33,91,3,307,434
"101","Crotone",85,9,171,0,72,252,23,78,5,320,426
"101","Crotone",86,5,145,0,61,211,25,66,2,240,333
"101","Crotone",87,13,98,1,72,184,21,48,1,253,323
"101","Crotone",88,4,79,0,56,139,11,33,1,193,238
"101","Crotone",89,2,55,0,36,93,16,22,1,156,195
"101","Crotone",90,5,51,1,37,94,16,16,2,164,198
"101","Crotone",91,4,51,0,22,77,12,7,3,121,143
"101","Crotone",92,0,22,0,22,44,10,5,0,67,82
"101","Crotone",93,0,8,0,8,16,5,2,0,47,54
"101","Crotone",94,2,9,0,9,20,2,6,1,34,43
"101","Crotone",95,1,5,0,14,20,4,2,0,38,44
"101","Crotone",96,0,10,0,11,21,1,2,0,23,26
"101","Crotone",97,0,7,0,8,15,1,1,0,26,28
"101","Crotone",98,1,4,0,7,12,0,2,0,22,24
"101","Crotone",99,0,2,0,6,8,1,0,0,6,7
"101","Crotone",100,0,4,0,4,8,2,1,0,15,18
"102","Vibo Valentia",0,684,0,0,0,684,673,0,0,0,673
"102","Vibo Valentia",1,746,0,0,0,746,746,0,0,0,746
"102","Vibo Valentia",2,730,0,0,0,730,730,0,0,0,730
"102","Vibo Valentia",3,740,0,0,0,740,787,0,0,0,787
"102","Vibo Valentia",4,801,0,0,0,801,756,0,0,0,756
"102","Vibo Valentia",5,774,0,0,0,774,760,0,0,0,760
"102","Vibo Valentia",6,843,0,0,0,843,756,0,0,0,756
"102","Vibo Valentia",7,796,0,0,0,796,800,0,0,0,800
"102","Vibo Valentia",8,872,0,0,0,872,800,0,0,0,800
"102","Vibo Valentia",9,824,0,0,0,824,762,0,0,0,762
"102","Vibo Valentia",10,933,0,0,0,933,782,0,0,0,782
"102","Vibo Valentia",11,886,0,0,0,886,765,0,0,0,765
"102","Vibo Valentia",12,866,0,0,0,866,774,0,0,0,774
"102","Vibo Valentia",13,908,0,0,0,908,832,0,0,0,832
"102","Vibo Valentia",14,911,0,0,0,911,868,0,0,0,868
"102","Vibo Valentia",15,944,0,0,0,944,823,0,0,0,823
"102","Vibo Valentia",16,962,0,0,0,962,877,1,0,0,878
"102","Vibo Valentia",17,984,0,0,0,984,907,0,0,0,907
"102","Vibo Valentia",18,1035,0,0,0,1035,970,4,0,0,974
"102","Vibo Valentia",19,1065,1,0,0,1066,997,19,0,0,1016
"102","Vibo Valentia",20,1006,2,0,0,1008,944,21,0,0,965
"102","Vibo Valentia",21,1103,9,0,0,1112,990,46,0,0,1036
"102","Vibo Valentia",22,1107,11,0,0,1118,974,85,0,0,1059
"102","Vibo Valentia",23,1082,32,0,0,1114,963,122,1,0,1086
"102","Vibo Valentia",24,1053,44,0,0,1097,879,174,0,0,1053
"102","Vibo Valentia",25,1027,52,1,0,1080,872,234,1,1,1108
"102","Vibo Valentia",26,979,97,1,0,1077,794,302,1,0,1097
"102","Vibo Valentia",27,995,139,0,0,1134,719,335,0,1,1055
"102","Vibo Valentia",28,923,180,1,0,1104,585,432,7,1,1025
"102","Vibo Valentia",29,852,239,1,0,1092,583,501,4,1,1089
"102","Vibo Valentia",30,790,276,1,0,1067,519,545,3,1,1068
"102","Vibo Valentia",31,686,369,1,0,1056,382,623,5,2,1012
"102","Vibo Valentia",32,608,458,2,0,1068,380,697,11,3,1091
"102","Vibo Valentia",33,579,474,5,1,1059,387,651,4,3,1045
"102","Vibo Valentia",34,532,551,2,0,1085,302,742,5,2,1051
"102","Vibo Valentia",35,495,624,5,0,1124,294,839,14,5,1152
"102","Vibo Valentia",36,473,683,9,1,1166,262,828,8,6,1104
"102","Vibo Valentia",37,405,684,6,1,1096,258,923,19,9,1209
"102","Vibo Valentia",38,395,756,7,0,1158,237,887,11,12,1147
"102","Vibo Valentia",39,373,776,6,2,1157,201,911,20,13,1145
"102","Vibo Valentia",40,347,814,5,2,1168,191,900,12,22,1125
"102","Vibo Valentia",41,313,762,15,0,1090,218,887,15,20,1140
"102","Vibo Valentia",42,309,817,11,1,1138,207,1027,24,12,1270
"102","Vibo Valentia",43,276,883,8,4,1171,185,948,20,24,1177
"102","Vibo Valentia",44,242,884,8,3,1137,195,944,18,29,1186
"102","Vibo Valentia",45,258,919,15,5,1197,174,1044,20,29,1267
"102","Vibo Valentia",46,240,885,10,4,1139,164,964,20,30,1178
"102","Vibo Valentia",47,244,981,9,6,1240,169,1032,14,35,1250
"102","Vibo Valentia",48,226,965,9,4,1204,122,1015,20,39,1196
"102","Vibo Valentia",49,196,922,24,3,1145,159,997,17,43,1216
"102","Vibo Valentia",50,202,893,4,10,1109,132,962,22,65,1181
"102","Vibo Valentia",51,178,892,30,4,1104,127,1000,15,60,1202
"102","Vibo Valentia",52,161,913,11,9,1094,134,933,17,71,1155
"102","Vibo Valentia",53,164,866,13,14,1057,116,853,20,64,1053
"102","Vibo Valentia",54,160,833,20,13,1026,116,876,14,86,1092
"102","Vibo Valentia",55,136,858,11,11,1016,102,804,12,94,1012
"102","Vibo Valentia",56,136,894,18,17,1065,118,783,20,90,1011
"102","Vibo Valentia",57,130,851,12,11,1004,81,821,14,86,1002
"102","Vibo Valentia",58,129,880,12,13,1034,106,781,6,108,1001
"102","Vibo Valentia",59,92,833,13,12,950,87,720,17,95,919
"102","Vibo Valentia",60,96,843,6,9,954,90,713,11,95,909
"102","Vibo Valentia",61,93,871,16,19,999,90,755,15,131,991
"102","Vibo Valentia",62,85,870,12,17,984,96,751,12,139,998
"102","Vibo Valentia",63,81,881,16,29,1007,79,747,13,166,1005
"102","Vibo Valentia",64,93,857,7,25,982,78,690,7,173,948
"102","Vibo Valentia",65,72,774,11,28,885,83,648,7,173,911
"102","Vibo Valentia",66,48,677,14,26,765,59,503,9,151,722
"102","Vibo Valentia",67,41,642,8,30,721,57,448,7,165,677
"102","Vibo Valentia",68,50,570,11,34,665,76,449,6,181,712
"102","Vibo Valentia",69,40,597,7,39,683,50,470,9,214,743
"102","Vibo Valentia",70,49,571,5,34,659,54,384,6,202,646
"102","Vibo Valentia",71,60,676,10,55,801,59,505,4,238,806
"102","Vibo Valentia",72,52,693,8,47,800,71,487,9,290,857
"102","Vibo Valentia",73,52,585,1,51,689,86,450,5,270,811
"102","Vibo Valentia",74,49,539,5,54,647,62,423,8,272,765
"102","Vibo Valentia",75,37,539,4,55,635,60,388,4,303,755
"102","Vibo Valentia",76,31,560,4,78,673,74,393,5,307,779
"102","Vibo Valentia",77,36,502,3,61,602,63,370,3,332,768
"102","Vibo Valentia",78,27,515,5,90,637,71,345,3,402,821
"102","Vibo Valentia",79,24,448,0,89,561,59,268,4,402,733
"102","Vibo Valentia",80,32,364,5,69,470,76,228,5,389,698
"102","Vibo Valentia",81,23,377,6,90,496,73,220,2,406,701
"102","Vibo Valentia",82,26,295,1,90,412,60,199,5,336,600
"102","Vibo Valentia",83,15,282,4,73,374,61,145,2,358,566
"102","Vibo Valentia",84,19,226,3,103,351,41,152,1,314,508
"102","Vibo Valentia",85,19,188,1,76,284,56,94,4,303,457
"102","Vibo Valentia",86,7,187,2,70,266,57,86,1,322,466
"102","Vibo Valentia",87,12,138,0,84,234,37,64,1,269,371
"102","Vibo Valentia",88,10,110,2,71,193,44,56,1,271,372
"102","Vibo Valentia",89,9,95,1,62,167,35,47,1,225,308
"102","Vibo Valentia",90,8,71,2,52,133,29,38,2,204,273
"102","Vibo Valentia",91,7,51,0,53,111,20,16,4,174,214
"102","Vibo Valentia",92,1,26,0,26,53,23,12,1,87,123
"102","Vibo Valentia",93,3,22,0,13,38,9,9,0,56,74
"102","Vibo Valentia",94,1,11,0,14,26,11,3,0,58,72
"102","Vibo Valentia",95,3,14,0,18,35,10,2,0,48,60
"102","Vibo Valentia",96,2,4,0,11,17,6,6,1,50,63
"102","Vibo Valentia",97,1,7,0,8,16,6,2,0,32,40
"102","Vibo Valentia",98,1,4,0,4,9,2,2,0,21,25
"102","Vibo Valentia",99,0,2,0,3,5,1,0,0,21,22
"102","Vibo Valentia",100,0,1,0,2,3,4,0,0,16,20
"103","Verbano-Cusio-Ossola",0,608,0,0,0,608,589,0,0,0,589
"103","Verbano-Cusio-Ossola",1,633,0,0,0,633,586,0,0,0,586
"103","Verbano-Cusio-Ossola",2,665,0,0,0,665,637,0,0,0,637
"103","Verbano-Cusio-Ossola",3,682,0,0,0,682,588,0,0,0,588
"103","Verbano-Cusio-Ossola",4,621,0,0,0,621,615,0,0,0,615
"103","Verbano-Cusio-Ossola",5,676,0,0,0,676,644,0,0,0,644
"103","Verbano-Cusio-Ossola",6,657,0,0,0,657,632,0,0,0,632
"103","Verbano-Cusio-Ossola",7,710,0,0,0,710,631,0,0,0,631
"103","Verbano-Cusio-Ossola",8,693,0,0,0,693,666,0,0,0,666
"103","Verbano-Cusio-Ossola",9,668,0,0,0,668,566,0,0,0,566
"103","Verbano-Cusio-Ossola",10,722,0,0,0,722,646,0,0,0,646
"103","Verbano-Cusio-Ossola",11,695,0,0,0,695,672,0,0,0,672
"103","Verbano-Cusio-Ossola",12,653,0,0,0,653,622,0,0,0,622
"103","Verbano-Cusio-Ossola",13,701,0,0,0,701,658,0,0,0,658
"103","Verbano-Cusio-Ossola",14,682,0,0,0,682,657,0,0,0,657
"103","Verbano-Cusio-Ossola",15,675,0,0,0,675,660,0,0,0,660
"103","Verbano-Cusio-Ossola",16,665,1,0,0,666,640,0,0,0,640
"103","Verbano-Cusio-Ossola",17,690,1,0,0,691,646,2,0,0,648
"103","Verbano-Cusio-Ossola",18,715,2,0,0,717,647,1,0,0,648
"103","Verbano-Cusio-Ossola",19,660,0,0,0,660,630,8,0,0,638
"103","Verbano-Cusio-Ossola",20,695,1,0,0,696,661,9,0,0,670
"103","Verbano-Cusio-Ossola",21,708,0,0,0,708,664,13,0,0,677
"103","Verbano-Cusio-Ossola",22,667,4,0,0,671,603,37,0,0,640
"103","Verbano-Cusio-Ossola",23,698,11,0,0,709,622,44,0,0,666
"103","Verbano-Cusio-Ossola",24,697,20,0,0,717,568,61,0,0,629
"103","Verbano-Cusio-Ossola",25,672,27,0,0,699,585,94,1,0,680
"103","Verbano-Cusio-Ossola",26,694,48,0,0,742,561,145,2,0,708
"103","Verbano-Cusio-Ossola",27,650,54,1,0,705,575,175,4,0,754
"103","Verbano-Cusio-Ossola",28,691,97,1,0,789,527,210,4,0,741
"103","Verbano-Cusio-Ossola",29,684,125,0,1,810,496,260,5,0,761
"103","Verbano-Cusio-Ossola",30,660,171,0,0,831,449,307,6,0,762
"103","Verbano-Cusio-Ossola",31,639,177,1,0,817,478,350,8,0,836
"103","Verbano-Cusio-Ossola",32,655,262,2,0,919,386,423,8,2,819
"103","Verbano-Cusio-Ossola",33,646,307,9,0,962,434,471,19,1,925
"103","Verbano-Cusio-Ossola",34,633,346,9,0,988,436,522,24,6,988
"103","Verbano-Cusio-Ossola",35,607,438,14,0,1059,446,611,29,2,1088
"103","Verbano-Cusio-Ossola",36,624,483,18,0,1125,420,692,27,3,1142
"103","Verbano-Cusio-Ossola",37,606,555,16,0,1177,446,668,51,11,1176
"103","Verbano-Cusio-Ossola",38,619,608,33,0,1260,408,767,47,7,1229
"103","Verbano-Cusio-Ossola",39,533,635,43,2,1213,394,795,69,5,1263
"103","Verbano-Cusio-Ossola",40,515,755,58,2,1330,337,873,69,10,1289
"103","Verbano-Cusio-Ossola",41,522,766,54,2,1344,328,829,72,15,1244
"103","Verbano-Cusio-Ossola",42,492,791,44,4,1331,332,937,86,24,1379
"103","Verbano-Cusio-Ossola",43,465,836,62,4,1367,287,1011,84,14,1396
"103","Verbano-Cusio-Ossola",44,417,839,53,3,1312,280,979,79,15,1353
"103","Verbano-Cusio-Ossola",45,401,927,86,3,1417,310,984,74,23,1391
"103","Verbano-Cusio-Ossola",46,416,937,72,5,1430,271,961,95,28,1355
"103","Verbano-Cusio-Ossola",47,376,951,81,7,1415,269,993,98,38,1398
"103","Verbano-Cusio-Ossola",48,324,964,78,6,1372,229,958,110,36,1333
"103","Verbano-Cusio-Ossola",49,313,879,89,7,1288,184,949,100,40,1273
"103","Verbano-Cusio-Ossola",50,266,843,89,7,1205,205,889,78,46,1218
"103","Verbano-Cusio-Ossola",51,227,900,68,8,1203,169,889,89,49,1196
"103","Verbano-Cusio-Ossola",52,205,845,66,12,1128,184,849,76,57,1166
"103","Verbano-Cusio-Ossola",53,196,852,74,12,1134,147,885,74,46,1152
"103","Verbano-Cusio-Ossola",54,199,856,79,15,1149,163,828,81,67,1139
"103","Verbano-Cusio-Ossola",55,162,845,58,8,1073,147,795,74,65,1081
"103","Verbano-Cusio-Ossola",56,164,805,70,15,1054,157,811,85,57,1110
"103","Verbano-Cusio-Ossola",57,160,797,67,16,1040,132,849,75,97,1153
"103","Verbano-Cusio-Ossola",58,163,854,53,25,1095,125,828,68,84,1105
"103","Verbano-Cusio-Ossola",59,127,813,66,18,1024,117,771,70,104,1062
"103","Verbano-Cusio-Ossola",60,115,804,49,41,1009,127,766,58,114,1065
"103","Verbano-Cusio-Ossola",61,151,893,46,31,1121,106,820,56,145,1127
"103","Verbano-Cusio-Ossola",62,119,847,55,40,1061,109,808,51,136,1104
"103","Verbano-Cusio-Ossola",63,121,916,47,38,1122,96,870,53,176,1195
"103","Verbano-Cusio-Ossola",64,126,883,49,30,1088,85,863,44,196,1188
"103","Verbano-Cusio-Ossola",65,115,897,50,55,1117,92,805,42,206,1145
"103","Verbano-Cusio-Ossola",66,85,638,36,31,790,63,562,37,179,841
"103","Verbano-Cusio-Ossola",67,90,695,35,38,858,62,679,35,233,1009
"103","Verbano-Cusio-Ossola",68,75,662,24,57,818,70,611,31,232,944
"103","Verbano-Cusio-Ossola",69,71,718,22,53,864,65,634,30,253,982
"103","Verbano-Cusio-Ossola",70,88,746,32,64,930,67,662,43,300,1072
"103","Verbano-Cusio-Ossola",71,94,820,31,82,1027,73,646,31,361,1111
"103","Verbano-Cusio-Ossola",72,92,746,25,81,944,76,635,29,363,1103
"103","Verbano-Cusio-Ossola",73,82,756,14,83,935,85,601,24,381,1091
"103","Verbano-Cusio-Ossola",74,73,661,20,66,820,63,529,19,417,1028
"103","Verbano-Cusio-Ossola",75,64,618,20,66,768,59,463,18,377,917
"103","Verbano-Cusio-Ossola",76,52,558,12,98,720,69,415,15,417,916
"103","Verbano-Cusio-Ossola",77,58,484,11,78,631,64,379,26,488,957
"103","Verbano-Cusio-Ossola",78,35,446,12,86,579,85,332,19,485,921
"103","Verbano-Cusio-Ossola",79,53,415,7,83,558,85,272,13,492,862
"103","Verbano-Cusio-Ossola",80,41,374,11,83,509,65,241,10,515,831
"103","Verbano-Cusio-Ossola",81,43,376,9,70,498,66,233,4,532,835
"103","Verbano-Cusio-Ossola",82,37,323,5,70,435,71,185,6,499,761
"103","Verbano-Cusio-Ossola",83,18,262,9,92,381,74,157,9,528,768
"103","Verbano-Cusio-Ossola",84,27,212,4,102,345,68,109,8,489,674
"103","Verbano-Cusio-Ossola",85,22,217,2,85,326,59,92,10,445,606
"103","Verbano-Cusio-Ossola",86,23,145,3,65,236,55,72,8,400,535
"103","Verbano-Cusio-Ossola",87,16,108,0,77,201,58,45,2,379,484
"103","Verbano-Cusio-Ossola",88,18,99,2,72,191,53,51,8,350,462
"103","Verbano-Cusio-Ossola",89,9,75,3,49,136,34,28,7,321,390
"103","Verbano-Cusio-Ossola",90,1,62,2,37,102,36,19,4,290,349
"103","Verbano-Cusio-Ossola",91,3,45,0,44,92,27,21,0,230,278
"103","Verbano-Cusio-Ossola",92,3,24,0,18,45,13,10,4,127,154
"103","Verbano-Cusio-Ossola",93,4,9,2,18,33,14,2,0,100,116
"103","Verbano-Cusio-Ossola",94,3,4,0,18,25,17,2,1,79,99
"103","Verbano-Cusio-Ossola",95,0,8,0,6,14,13,3,1,90,107
"103","Verbano-Cusio-Ossola",96,0,5,0,7,12,10,2,0,68,80
"103","Verbano-Cusio-Ossola",97,1,3,0,11,15,5,2,1,59,67
"103","Verbano-Cusio-Ossola",98,1,3,0,3,7,9,0,0,53,62
"103","Verbano-Cusio-Ossola",99,1,4,0,2,7,7,1,0,28,36
"103","Verbano-Cusio-Ossola",100,1,3,0,6,10,9,0,0,45,54
"104","Olbia-Tempio",0,694,0,0,0,694,699,0,0,0,699
"104","Olbia-Tempio",1,738,0,0,0,738,700,0,0,0,700
"104","Olbia-Tempio",2,715,0,0,0,715,685,0,0,0,685
"104","Olbia-Tempio",3,776,0,0,0,776,705,0,0,0,705
"104","Olbia-Tempio",4,785,0,0,0,785,683,0,0,0,683
"104","Olbia-Tempio",5,706,0,0,0,706,685,0,0,0,685
"104","Olbia-Tempio",6,699,0,0,0,699,682,0,0,0,682
"104","Olbia-Tempio",7,669,0,0,0,669,622,0,0,0,622
"104","Olbia-Tempio",8,722,0,0,0,722,662,0,0,0,662
"104","Olbia-Tempio",9,656,0,0,0,656,682,0,0,0,682
"104","Olbia-Tempio",10,637,0,0,0,637,660,0,0,0,660
"104","Olbia-Tempio",11,674,0,0,0,674,615,0,0,0,615
"104","Olbia-Tempio",12,691,0,0,0,691,666,0,0,0,666
"104","Olbia-Tempio",13,602,0,0,0,602,617,0,0,0,617
"104","Olbia-Tempio",14,699,0,0,0,699,622,0,0,0,622
"104","Olbia-Tempio",15,675,0,0,0,675,573,0,0,0,573
"104","Olbia-Tempio",16,677,0,0,0,677,648,0,0,0,648
"104","Olbia-Tempio",17,687,0,0,0,687,632,1,0,0,633
"104","Olbia-Tempio",18,715,1,0,0,716,634,1,0,0,635
"104","Olbia-Tempio",19,716,0,0,0,716,680,4,0,0,684
"104","Olbia-Tempio",20,723,1,0,0,724,696,14,0,0,710
"104","Olbia-Tempio",21,767,2,0,0,769,699,24,0,0,723
"104","Olbia-Tempio",22,802,7,0,0,809,681,52,0,0,733
"104","Olbia-Tempio",23,780,13,0,0,793,747,67,0,0,814
"104","Olbia-Tempio",24,794,29,2,0,825,671,89,2,0,762
"104","Olbia-Tempio",25,784,45,1,0,830,682,143,2,0,827
"104","Olbia-Tempio",26,814,58,1,0,873,728,191,1,0,920
"104","Olbia-Tempio",27,819,89,0,0,908,641,222,2,1,866
"104","Olbia-Tempio",28,780,116,1,0,897,679,251,4,0,934
"104","Olbia-Tempio",29,798,153,0,2,953,656,324,2,1,983
"104","Olbia-Tempio",30,799,233,4,0,1036,557,381,6,2,946
"104","Olbia-Tempio",31,767,280,5,1,1053,608,458,9,0,1075
"104","Olbia-Tempio",32,737,310,3,0,1050,588,529,12,0,1129
"104","Olbia-Tempio",33,738,384,4,1,1127,548,595,16,4,1163
"104","Olbia-Tempio",34,702,430,8,1,1141,519,626,24,5,1174
"104","Olbia-Tempio",35,684,530,7,0,1221,475,681,23,6,1185
"104","Olbia-Tempio",36,703,589,12,1,1305,485,771,21,8,1285
"104","Olbia-Tempio",37,674,666,16,2,1358,451,815,30,7,1303
"104","Olbia-Tempio",38,654,696,13,0,1363,424,878,32,3,1337
"104","Olbia-Tempio",39,569,682,15,1,1267,402,840,44,13,1299
"104","Olbia-Tempio",40,545,744,19,0,1308,343,919,36,9,1307
"104","Olbia-Tempio",41,477,799,23,2,1301,333,875,53,8,1269
"104","Olbia-Tempio",42,487,879,37,1,1404,319,884,50,20,1273
"104","Olbia-Tempio",43,393,808,29,4,1234,297,932,56,11,1296
"104","Olbia-Tempio",44,359,854,38,1,1252,287,952,50,20,1309
"104","Olbia-Tempio",45,378,880,41,4,1303,296,894,43,27,1260
"104","Olbia-Tempio",46,316,907,44,7,1274,258,931,51,25,1265
"104","Olbia-Tempio",47,341,907,50,5,1303,243,1011,59,18,1331
"104","Olbia-Tempio",48,272,850,41,6,1169,208,906,57,41,1212
"104","Olbia-Tempio",49,241,867,41,5,1154,192,863,54,36,1145
"104","Olbia-Tempio",50,207,907,43,3,1160,161,919,55,35,1170
"104","Olbia-Tempio",51,211,883,46,10,1150,170,850,52,48,1120
"104","Olbia-Tempio",52,213,831,34,12,1090,151,816,53,49,1069
"104","Olbia-Tempio",53,186,801,43,9,1039,127,901,47,41,1116
"104","Olbia-Tempio",54,168,796,38,16,1018,116,842,41,63,1062
"104","Olbia-Tempio",55,168,790,29,12,999,126,796,38,70,1030
"104","Olbia-Tempio",56,153,796,39,19,1007,114,784,43,57,998
"104","Olbia-Tempio",57,151,792,32,12,987,108,774,39,78,999
"104","Olbia-Tempio",58,122,759,39,14,934,114,717,23,67,921
"104","Olbia-Tempio",59,132,788,42,23,985,118,686,34,80,918
"104","Olbia-Tempio",60,125,734,28,19,906,90,755,30,100,975
"104","Olbia-Tempio",61,104,774,31,16,925,101,708,29,116,954
"104","Olbia-Tempio",62,107,797,39,17,960,103,687,27,120,937
"104","Olbia-Tempio",63,124,770,32,31,957,94,720,31,123,968
"104","Olbia-Tempio",64,99,760,47,32,938,83,684,25,132,924
"104","Olbia-Tempio",65,97,735,24,30,886,91,596,21,145,853
"104","Olbia-Tempio",66,70,683,19,20,792,72,582,22,156,832
"104","Olbia-Tempio",67,95,620,20,24,759,78,577,22,144,821
"104","Olbia-Tempio",68,78,604,16,30,728,81,494,17,180,772
"104","Olbia-Tempio",69,64,628,10,38,740,68,526,26,175,795
"104","Olbia-Tempio",70,70,580,16,39,705,90,475,13,203,781
"104","Olbia-Tempio",71,74,627,16,43,760,93,524,19,218,854
"104","Olbia-Tempio",72,71,600,21,36,728,69,429,12,227,737
"104","Olbia-Tempio",73,66,537,10,39,652,86,377,15,247,725
"104","Olbia-Tempio",74,59,435,17,48,559,85,324,11,268,688
"104","Olbia-Tempio",75,75,423,7,40,545,75,290,7,245,617
"104","Olbia-Tempio",76,61,376,8,43,488,83,249,5,238,575
"104","Olbia-Tempio",77,65,372,5,52,494,83,246,5,286,620
"104","Olbia-Tempio",78,56,304,5,48,413,80,192,3,262,537
"104","Olbia-Tempio",79,55,328,5,56,444,72,187,5,256,520
"104","Olbia-Tempio",80,39,264,9,58,370,79,140,4,258,481
"104","Olbia-Tempio",81,40,272,0,63,375,70,126,2,336,534
"104","Olbia-Tempio",82,28,218,1,41,288,68,97,1,263,429
"104","Olbia-Tempio",83,39,190,3,48,280,56,74,1,251,382
"104","Olbia-Tempio",84,22,183,0,42,247,40,68,1,248,357
"104","Olbia-Tempio",85,31,118,1,48,198,52,54,1,227,334
"104","Olbia-Tempio",86,15,113,0,44,172,40,40,1,188,269
"104","Olbia-Tempio",87,21,100,0,51,172,50,41,1,228,320
"104","Olbia-Tempio",88,12,81,0,62,155,39,24,2,200,265
"104","Olbia-Tempio",89,11,50,1,35,97,25,12,4,156,197
"104","Olbia-Tempio",90,9,39,0,23,71,22,9,1,111,143
"104","Olbia-Tempio",91,5,39,1,22,67,16,8,0,113,137
"104","Olbia-Tempio",92,4,22,1,12,39,16,4,0,98,118
"104","Olbia-Tempio",93,5,17,0,12,34,10,3,1,45,59
"104","Olbia-Tempio",94,2,9,0,12,23,8,2,0,36,46
"104","Olbia-Tempio",95,2,10,0,11,23,7,2,0,39,48
"104","Olbia-Tempio",96,5,9,0,12,26,2,1,0,36,39
"104","Olbia-Tempio",97,2,4,0,5,11,2,0,0,26,28
"104","Olbia-Tempio",98,2,2,0,8,12,3,1,0,27,31
"104","Olbia-Tempio",99,0,2,0,2,4,2,0,0,10,12
"104","Olbia-Tempio",100,1,0,0,8,9,1,0,0,22,23
"105","Ogliastra",0,244,0,0,0,244,229,0,0,0,229
"105","Ogliastra",1,246,0,0,0,246,231,0,0,0,231
"105","Ogliastra",2,257,0,0,0,257,197,0,0,0,197
"105","Ogliastra",3,268,0,0,0,268,240,0,0,0,240
"105","Ogliastra",4,242,0,0,0,242,227,0,0,0,227
"105","Ogliastra",5,233,0,0,0,233,233,0,0,0,233
"105","Ogliastra",6,259,0,0,0,259,232,0,0,0,232
"105","Ogliastra",7,253,0,0,0,253,226,0,0,0,226
"105","Ogliastra",8,264,0,0,0,264,228,0,0,0,228
"105","Ogliastra",9,222,0,0,0,222,226,0,0,0,226
"105","Ogliastra",10,278,0,0,0,278,259,0,0,0,259
"105","Ogliastra",11,275,0,0,0,275,242,0,0,0,242
"105","Ogliastra",12,255,0,0,0,255,216,0,0,0,216
"105","Ogliastra",13,250,0,0,0,250,242,0,0,0,242
"105","Ogliastra",14,276,0,0,0,276,245,0,0,0,245
"105","Ogliastra",15,303,0,0,0,303,282,0,0,0,282
"105","Ogliastra",16,287,0,0,0,287,267,0,0,0,267
"105","Ogliastra",17,319,0,0,0,319,243,0,0,0,243
"105","Ogliastra",18,288,0,0,0,288,270,0,0,0,270
"105","Ogliastra",19,282,0,0,0,282,262,2,0,0,264
"105","Ogliastra",20,318,1,0,0,319,344,3,0,0,347
"105","Ogliastra",21,303,1,0,0,304,327,13,0,0,340
"105","Ogliastra",22,318,0,0,0,318,283,13,0,0,296
"105","Ogliastra",23,371,4,0,0,375,287,20,0,0,307
"105","Ogliastra",24,343,9,0,0,352,297,26,0,0,323
"105","Ogliastra",25,366,10,0,0,376,284,49,1,0,334
"105","Ogliastra",26,324,19,0,0,343,266,43,0,0,309
"105","Ogliastra",27,312,28,0,0,340,260,70,0,0,330
"105","Ogliastra",28,315,21,0,0,336,251,78,3,1,333
"105","Ogliastra",29,336,40,1,0,377,225,103,0,0,328
"105","Ogliastra",30,277,51,1,0,329,251,128,0,0,379
"105","Ogliastra",31,317,85,0,0,402,219,131,0,2,352
"105","Ogliastra",32,300,73,1,0,374,183,157,4,3,347
"105","Ogliastra",33,308,126,1,0,435,212,176,8,1,397
"105","Ogliastra",34,289,135,0,0,424,173,203,2,2,380
"105","Ogliastra",35,287,128,2,0,417,171,245,2,3,421
"105","Ogliastra",36,255,157,1,0,413,136,243,7,1,387
"105","Ogliastra",37,279,169,10,0,458,136,262,8,2,408
"105","Ogliastra",38,219,212,4,1,436,119,270,3,1,393
"105","Ogliastra",39,230,198,3,0,431,140,281,7,5,433
"105","Ogliastra",40,188,244,7,0,439,105,320,6,0,431
"105","Ogliastra",41,187,256,7,0,450,122,290,7,6,425
"105","Ogliastra",42,191,289,7,1,488,97,323,7,5,432
"105","Ogliastra",43,163,304,6,1,474,80,325,1,8,414
"105","Ogliastra",44,153,296,5,1,455,95,347,10,9,461
"105","Ogliastra",45,151,298,9,1,459,93,356,6,10,465
"105","Ogliastra",46,138,294,10,1,443,94,342,12,7,455
"105","Ogliastra",47,117,361,9,0,487,92,349,10,11,462
"105","Ogliastra",48,105,333,12,2,452,96,349,6,15,466
"105","Ogliastra",49,94,332,9,2,437,86,321,10,15,432
"105","Ogliastra",50,126,317,13,0,456,70,357,11,19,457
"105","Ogliastra",51,102,336,7,2,447,67,299,7,20,393
"105","Ogliastra",52,89,304,7,1,401,65,308,10,16,399
"105","Ogliastra",53,95,310,7,1,413,67,312,2,18,399
"105","Ogliastra",54,64,302,10,3,379,45,336,13,19,413
"105","Ogliastra",55,84,280,8,7,379,57,323,7,30,417
"105","Ogliastra",56,87,295,9,4,395,72,313,6,23,414
"105","Ogliastra",57,85,305,10,5,405,64,306,7,25,402
"105","Ogliastra",58,53,293,10,5,361,68,271,11,27,377
"105","Ogliastra",59,90,288,6,5,389,63,239,7,25,334
"105","Ogliastra",60,58,265,5,6,334,44,250,8,42,344
"105","Ogliastra",61,72,273,5,7,357,56,278,3,46,383
"105","Ogliastra",62,50,275,3,4,332,47,245,7,53,352
"105","Ogliastra",63,57,255,7,11,330,48,244,3,60,355
"105","Ogliastra",64,52,253,9,2,316,46,222,5,55,328
"105","Ogliastra",65,45,239,5,6,295,48,221,4,66,339
"105","Ogliastra",66,38,232,5,10,285,42,219,2,64,327
"105","Ogliastra",67,39,256,3,8,306,60,207,6,74,347
"105","Ogliastra",68,41,219,1,13,274,53,171,2,91,317
"105","Ogliastra",69,45,235,4,8,292,48,193,4,84,329
"105","Ogliastra",70,29,209,5,10,253,46,159,5,99,309
"105","Ogliastra",71,41,223,1,9,274,59,203,2,106,370
"105","Ogliastra",72,43,211,2,11,267,50,153,3,107,313
"105","Ogliastra",73,37,195,2,18,252,73,188,5,102,368
"105","Ogliastra",74,28,167,0,18,213,56,117,0,117,290
"105","Ogliastra",75,32,191,0,17,240,53,138,3,121,315
"105","Ogliastra",76,23,161,3,15,202,45,88,0,128,261
"105","Ogliastra",77,25,158,2,18,203,45,94,2,133,274
"105","Ogliastra",78,38,166,2,21,227,52,96,2,126,276
"105","Ogliastra",79,17,131,1,15,164,49,71,1,144,265
"105","Ogliastra",80,16,141,0,25,182,40,52,1,151,244
"105","Ogliastra",81,20,128,1,30,179,46,43,7,144,240
"105","Ogliastra",82,29,115,0,20,164,36,35,0,116,187
"105","Ogliastra",83,20,106,0,18,144,42,42,2,126,212
"105","Ogliastra",84,15,102,0,24,141,40,33,3,127,203
"105","Ogliastra",85,13,90,0,22,125,40,30,1,120,191
"105","Ogliastra",86,6,59,0,22,87,24,18,3,93,138
"105","Ogliastra",87,9,57,0,18,84,34,13,0,88,135
"105","Ogliastra",88,4,50,0,13,67,25,11,3,100,139
"105","Ogliastra",89,9,29,0,20,58,23,9,2,86,120
"105","Ogliastra",90,5,27,0,14,46,15,3,0,59,77
"105","Ogliastra",91,2,13,0,10,25,15,7,0,70,92
"105","Ogliastra",92,3,20,0,17,40,16,1,0,46,63
"105","Ogliastra",93,0,9,0,11,20,4,2,0,21,27
"105","Ogliastra",94,4,7,0,4,15,5,1,0,22,28
"105","Ogliastra",95,1,9,0,11,21,6,0,0,22,28
"105","Ogliastra",96,0,2,0,5,7,1,0,0,15,16
"105","Ogliastra",97,0,2,0,3,5,2,0,0,13,15
"105","Ogliastra",98,0,2,0,1,3,4,0,0,13,17
"105","Ogliastra",99,0,3,0,2,5,0,0,0,6,6
"105","Ogliastra",100,0,0,0,1,1,3,0,0,11,14
"106","Medio Campidano",0,378,0,0,0,378,361,0,0,0,361
"106","Medio Campidano",1,361,0,0,0,361,332,0,0,0,332
"106","Medio Campidano",2,371,0,0,0,371,408,0,0,0,408
"106","Medio Campidano",3,389,0,0,0,389,393,0,0,0,393
"106","Medio Campidano",4,384,0,0,0,384,356,0,0,0,356
"106","Medio Campidano",5,372,0,0,0,372,384,0,0,0,384
"106","Medio Campidano",6,409,0,0,0,409,341,0,0,0,341
"106","Medio Campidano",7,401,0,0,0,401,357,0,0,0,357
"106","Medio Campidano",8,404,0,0,0,404,342,0,0,0,342
"106","Medio Campidano",9,426,0,0,0,426,367,0,0,0,367
"106","Medio Campidano",10,414,0,0,0,414,405,0,0,0,405
"106","Medio Campidano",11,407,0,0,0,407,416,0,0,0,416
"106","Medio Campidano",12,460,0,0,0,460,405,0,0,0,405
"106","Medio Campidano",13,434,0,0,0,434,401,0,0,0,401
"106","Medio Campidano",14,435,0,0,0,435,400,0,0,0,400
"106","Medio Campidano",15,464,0,0,0,464,401,0,0,0,401
"106","Medio Campidano",16,444,0,0,0,444,413,0,0,0,413
"106","Medio Campidano",17,469,0,0,0,469,471,0,0,0,471
"106","Medio Campidano",18,504,0,0,0,504,481,0,0,0,481
"106","Medio Campidano",19,503,0,0,0,503,503,3,0,0,506
"106","Medio Campidano",20,527,1,0,0,528,511,6,0,0,517
"106","Medio Campidano",21,542,1,0,0,543,538,7,0,0,545
"106","Medio Campidano",22,575,2,0,0,577,544,12,0,0,556
"106","Medio Campidano",23,541,12,0,0,553,533,27,0,0,560
"106","Medio Campidano",24,534,7,0,0,541,545,32,0,0,577
"106","Medio Campidano",25,617,19,0,0,636,518,48,0,0,566
"106","Medio Campidano",26,627,21,0,0,648,529,77,0,0,606
"106","Medio Campidano",27,613,37,0,0,650,509,97,0,1,607
"106","Medio Campidano",28,569,50,0,0,619,479,143,1,1,624
"106","Medio Campidano",29,614,84,0,0,698,459,161,1,1,622
"106","Medio Campidano",30,586,94,0,0,680,458,220,0,0,678
"106","Medio Campidano",31,586,134,2,0,722,413,238,1,0,652
"106","Medio Campidano",32,520,171,1,0,692,355,275,2,1,633
"106","Medio Campidano",33,496,227,2,0,725,345,328,1,2,676
"106","Medio Campidano",34,464,279,2,0,745,319,365,6,1,691
"106","Medio Campidano",35,478,268,7,1,754,272,397,12,2,683
"106","Medio Campidano",36,438,304,1,0,743,267,493,9,3,772
"106","Medio Campidano",37,435,384,3,0,822,263,513,15,4,795
"106","Medio Campidano",38,370,376,8,1,755,228,501,11,0,740
"106","Medio Campidano",39,351,443,6,1,801,175,505,8,3,691
"106","Medio Campidano",40,314,451,5,3,773,176,575,18,12,781
"106","Medio Campidano",41,282,506,13,0,801,173,524,9,10,716
"106","Medio Campidano",42,306,508,10,7,831,167,599,13,12,791
"106","Medio Campidano",43,269,490,13,1,773,102,581,19,11,713
"106","Medio Campidano",44,231,576,13,2,822,133,648,18,11,810
"106","Medio Campidano",45,235,605,21,4,865,114,634,20,15,783
"106","Medio Campidano",46,208,608,19,7,842,117,633,18,21,789
"106","Medio Campidano",47,202,623,16,2,843,102,632,15,26,775
"106","Medio Campidano",48,185,593,13,3,794,118,636,16,25,795
"106","Medio Campidano",49,159,584,12,4,759,90,653,14,29,786
"106","Medio Campidano",50,145,601,15,4,765,82,640,23,33,778
"106","Medio Campidano",51,137,588,18,7,750,80,596,11,33,720
"106","Medio Campidano",52,119,591,22,7,739,98,584,20,34,736
"106","Medio Campidano",53,124,551,17,11,703,57,580,21,36,694
"106","Medio Campidano",54,125,606,13,10,754,69,619,21,36,745
"106","Medio Campidano",55,116,568,14,7,705,73,592,16,34,715
"106","Medio Campidano",56,109,595,10,9,723,77,580,9,59,725
"106","Medio Campidano",57,98,595,19,12,724,73,577,6,62,718
"106","Medio Campidano",58,88,582,14,8,692,72,547,14,70,703
"106","Medio Campidano",59,92,558,17,13,680,63,554,14,50,681
"106","Medio Campidano",60,79,589,13,15,696,61,560,8,75,704
"106","Medio Campidano",61,94,566,10,18,688,74,525,8,78,685
"106","Medio Campidano",62,93,568,6,14,681,60,513,6,96,675
"106","Medio Campidano",63,103,547,7,14,671,63,515,5,77,660
"106","Medio Campidano",64,74,573,11,20,678,54,463,10,100,627
"106","Medio Campidano",65,80,507,13,17,617,57,420,5,88,570
"106","Medio Campidano",66,69,474,3,21,567,56,395,8,104,563
"106","Medio Campidano",67,79,472,6,24,581,65,415,12,129,621
"106","Medio Campidano",68,64,439,9,20,532,50,365,8,120,543
"106","Medio Campidano",69,64,437,7,28,536,48,372,5,149,574
"106","Medio Campidano",70,64,396,8,24,492,52,353,5,164,574
"106","Medio Campidano",71,69,402,9,45,525,70,345,2,187,604
"106","Medio Campidano",72,81,429,4,30,544,66,343,2,194,605
"106","Medio Campidano",73,65,377,4,25,471,67,312,2,195,576
"106","Medio Campidano",74,48,349,6,40,443,65,270,2,187,524
"106","Medio Campidano",75,66,318,4,25,413,50,237,5,209,501
"106","Medio Campidano",76,32,278,1,34,345,70,193,2,209,474
"106","Medio Campidano",77,52,316,1,48,417,42,218,3,251,514
"106","Medio Campidano",78,60,297,1,50,408,63,160,6,282,511
"106","Medio Campidano",79,40,259,5,35,339,52,151,1,284,488
"106","Medio Campidano",80,35,232,3,43,313,36,132,5,266,439
"106","Medio Campidano",81,44,241,0,50,335,54,88,0,282,424
"106","Medio Campidano",82,32,183,2,46,263,47,108,0,270,425
"106","Medio Campidano",83,21,165,1,40,227,59,84,2,260,405
"106","Medio Campidano",84,18,144,1,40,203,42,72,2,261,377
"106","Medio Campidano",85,16,127,1,37,181,45,43,2,222,312
"106","Medio Campidano",86,21,73,0,27,121,27,32,0,203,262
"106","Medio Campidano",87,9,93,0,26,128,24,29,1,196,250
"106","Medio Campidano",88,11,67,0,23,101,26,16,0,164,206
"106","Medio Campidano",89,8,42,0,27,77,25,11,0,143,179
"106","Medio Campidano",90,4,35,0,13,52,22,8,1,122,153
"106","Medio Campidano",91,3,27,0,18,48,10,10,0,99,119
"106","Medio Campidano",92,2,25,0,15,42,5,3,0,75,83
"106","Medio Campidano",93,4,4,0,5,13,6,3,0,43,52
"106","Medio Campidano",94,0,4,0,8,12,4,5,0,45,54
"106","Medio Campidano",95,1,4,0,12,17,5,0,0,27,32
"106","Medio Campidano",96,0,8,0,7,15,5,3,1,26,35
"106","Medio Campidano",97,0,4,0,4,8,2,0,0,28,30
"106","Medio Campidano",98,0,1,0,3,4,5,0,0,12,17
"106","Medio Campidano",99,1,1,0,4,6,2,0,0,13,15
"106","Medio Campidano",100,0,0,0,6,6,2,1,0,13,16
"107","Carbonia-Iglesias",0,443,0,0,0,443,414,0,0,0,414
"107","Carbonia-Iglesias",1,469,0,0,0,469,406,0,0,0,406
"107","Carbonia-Iglesias",2,453,0,0,0,453,434,0,0,0,434
"107","Carbonia-Iglesias",3,430,0,0,0,430,404,0,0,0,404
"107","Carbonia-Iglesias",4,454,0,0,0,454,425,0,0,0,425
"107","Carbonia-Iglesias",5,433,0,0,0,433,439,0,0,0,439
"107","Carbonia-Iglesias",6,460,0,0,0,460,427,0,0,0,427
"107","Carbonia-Iglesias",7,485,0,0,0,485,422,0,0,0,422
"107","Carbonia-Iglesias",8,465,0,0,0,465,414,0,0,0,414
"107","Carbonia-Iglesias",9,513,0,0,0,513,453,0,0,0,453
"107","Carbonia-Iglesias",10,484,0,0,0,484,425,0,0,0,425
"107","Carbonia-Iglesias",11,531,0,0,0,531,536,0,0,0,536
"107","Carbonia-Iglesias",12,509,0,0,0,509,448,0,0,0,448
"107","Carbonia-Iglesias",13,514,0,0,0,514,425,0,0,0,425
"107","Carbonia-Iglesias",14,532,0,0,0,532,462,0,0,0,462
"107","Carbonia-Iglesias",15,546,0,0,0,546,477,0,0,0,477
"107","Carbonia-Iglesias",16,570,0,0,0,570,504,0,0,0,504
"107","Carbonia-Iglesias",17,586,0,0,0,586,537,0,0,0,537
"107","Carbonia-Iglesias",18,630,0,0,0,630,584,1,0,0,585
"107","Carbonia-Iglesias",19,636,0,0,0,636,658,0,0,0,658
"107","Carbonia-Iglesias",20,704,0,0,0,704,644,3,1,0,648
"107","Carbonia-Iglesias",21,684,0,0,0,684,689,9,0,0,698
"107","Carbonia-Iglesias",22,717,7,0,0,724,688,20,0,0,708
"107","Carbonia-Iglesias",23,729,5,0,0,734,690,22,0,0,712
"107","Carbonia-Iglesias",24,740,8,0,0,748,670,50,0,0,720
"107","Carbonia-Iglesias",25,707,11,0,0,718,626,64,0,0,690
"107","Carbonia-Iglesias",26,742,28,0,0,770,669,76,0,0,745
"107","Carbonia-Iglesias",27,743,39,0,1,783,645,108,2,0,755
"107","Carbonia-Iglesias",28,771,61,0,0,832,638,142,3,1,784
"107","Carbonia-Iglesias",29,751,94,0,0,845,558,200,3,0,761
"107","Carbonia-Iglesias",30,704,113,0,1,818,556,209,3,0,768
"107","Carbonia-Iglesias",31,682,145,0,0,827,503,292,1,1,797
"107","Carbonia-Iglesias",32,636,189,2,0,827,454,341,9,1,805
"107","Carbonia-Iglesias",33,660,269,0,0,929,442,373,8,1,824
"107","Carbonia-Iglesias",34,650,288,2,0,940,415,423,10,6,854
"107","Carbonia-Iglesias",35,590,325,8,0,923,398,520,17,6,941
"107","Carbonia-Iglesias",36,605,372,5,0,982,381,511,21,3,916
"107","Carbonia-Iglesias",37,577,441,11,0,1029,356,603,15,4,978
"107","Carbonia-Iglesias",38,499,460,12,0,971,312,570,19,7,908
"107","Carbonia-Iglesias",39,481,507,15,4,1007,264,662,17,8,951
"107","Carbonia-Iglesias",40,406,485,19,1,911,252,616,29,6,903
"107","Carbonia-Iglesias",41,401,506,13,0,920,223,661,33,9,926
"107","Carbonia-Iglesias",42,329,592,19,1,941,245,674,33,12,964
"107","Carbonia-Iglesias",43,292,516,20,1,829,201,736,34,17,988
"107","Carbonia-Iglesias",44,304,625,28,2,959,201,699,33,13,946
"107","Carbonia-Iglesias",45,258,636,34,4,932,197,773,32,18,1020
"107","Carbonia-Iglesias",46,241,711,27,2,981,201,751,35,24,1011
"107","Carbonia-Iglesias",47,267,743,21,2,1033,170,791,48,32,1041
"107","Carbonia-Iglesias",48,202,736,42,3,983,138,844,30,31,1043
"107","Carbonia-Iglesias",49,204,748,37,6,995,151,868,32,28,1079
"107","Carbonia-Iglesias",50,201,747,28,5,981,144,833,40,29,1046
"107","Carbonia-Iglesias",51,187,761,28,8,984,136,850,35,36,1057
"107","Carbonia-Iglesias",52,161,785,28,15,989,113,829,27,36,1005
"107","Carbonia-Iglesias",53,197,792,24,12,1025,118,846,40,53,1057
"107","Carbonia-Iglesias",54,171,826,26,15,1038,131,823,27,73,1054
"107","Carbonia-Iglesias",55,142,788,36,11,977,131,858,26,69,1084
"107","Carbonia-Iglesias",56,131,779,29,17,956,103,847,26,71,1047
"107","Carbonia-Iglesias",57,130,852,28,16,1026,103,759,32,81,975
"107","Carbonia-Iglesias",58,129,899,27,14,1069,106,758,32,103,999
"107","Carbonia-Iglesias",59,105,851,25,29,1010,109,857,22,98,1086
"107","Carbonia-Iglesias",60,121,836,28,22,1007,85,796,20,111,1012
"107","Carbonia-Iglesias",61,111,874,24,21,1030,90,743,29,111,973
"107","Carbonia-Iglesias",62,101,803,34,28,966,107,716,23,122,968
"107","Carbonia-Iglesias",63,104,886,29,29,1048,107,707,25,137,976
"107","Carbonia-Iglesias",64,92,781,21,27,921,105,670,19,136,930
"107","Carbonia-Iglesias",65,73,715,16,33,837,81,630,18,140,869
"107","Carbonia-Iglesias",66,71,602,21,31,725,76,544,20,140,780
"107","Carbonia-Iglesias",67,53,523,13,24,613,68,417,13,145,643
"107","Carbonia-Iglesias",68,64,583,19,34,700,57,489,14,153,713
"107","Carbonia-Iglesias",69,62,572,11,27,672,85,481,10,181,757
"107","Carbonia-Iglesias",70,57,533,9,30,629,78,430,15,215,738
"107","Carbonia-Iglesias",71,61,538,7,42,648,77,444,12,227,760
"107","Carbonia-Iglesias",72,44,493,11,46,594,74,422,8,269,773
"107","Carbonia-Iglesias",73,42,416,13,33,504,59,336,11,240,646
"107","Carbonia-Iglesias",74,44,387,8,35,474,65,310,6,222,603
"107","Carbonia-Iglesias",75,43,362,7,38,450,57,255,8,254,574
"107","Carbonia-Iglesias",76,31,344,5,35,415,59,237,8,279,583
"107","Carbonia-Iglesias",77,45,364,5,41,455,52,240,7,271,570
"107","Carbonia-Iglesias",78,39,317,9,45,410,45,202,7,314,568
"107","Carbonia-Iglesias",79,24,320,6,53,403,50,211,4,306,571
"107","Carbonia-Iglesias",80,26,275,1,44,346,58,162,4,302,526
"107","Carbonia-Iglesias",81,31,280,2,61,374,65,143,5,353,566
"107","Carbonia-Iglesias",82,24,238,4,46,312,58,119,4,372,553
"107","Carbonia-Iglesias",83,17,235,1,66,319,51,106,3,376,536
"107","Carbonia-Iglesias",84,29,168,3,50,250,39,84,2,291,416
"107","Carbonia-Iglesias",85,21,172,2,74,269,47,67,0,312,426
"107","Carbonia-Iglesias",86,23,108,2,52,185,32,50,2,263,347
"107","Carbonia-Iglesias",87,15,106,2,48,171,32,42,3,250,327
"107","Carbonia-Iglesias",88,10,90,0,46,146,24,35,1,254,314
"107","Carbonia-Iglesias",89,6,80,0,34,120,29,26,1,190,246
"107","Carbonia-Iglesias",90,4,48,3,23,78,13,4,1,152,170
"107","Carbonia-Iglesias",91,2,42,0,31,75,14,8,1,139,162
"107","Carbonia-Iglesias",92,1,34,0,27,62,4,6,1,104,115
"107","Carbonia-Iglesias",93,1,13,0,18,32,9,2,0,55,66
"107","Carbonia-Iglesias",94,2,11,0,10,23,6,1,1,48,56
"107","Carbonia-Iglesias",95,0,17,0,13,30,2,4,0,44,50
"107","Carbonia-Iglesias",96,0,7,0,3,10,4,0,0,33,37
"107","Carbonia-Iglesias",97,0,4,0,7,11,4,0,0,34,38
"107","Carbonia-Iglesias",98,0,2,0,3,5,2,0,0,19,21
"107","Carbonia-Iglesias",99,1,4,0,3,8,0,0,0,7,7
"107","Carbonia-Iglesias",100,0,1,0,4,5,0,0,0,18,18
"108","Monza e della Brianza",0,4046,0,0,0,4046,3921,0,0,0,3921
"108","Monza e della Brianza",1,4271,0,0,0,4271,4060,0,0,0,4060
"108","Monza e della Brianza",2,4410,0,0,0,4410,4141,0,0,0,4141
"108","Monza e della Brianza",3,4334,0,0,0,4334,4192,0,0,0,4192
"108","Monza e della Brianza",4,4382,0,0,0,4382,4135,0,0,0,4135
"108","Monza e della Brianza",5,4407,0,0,0,4407,4112,0,0,0,4112
"108","Monza e della Brianza",6,4223,0,0,0,4223,3967,0,0,0,3967
"108","Monza e della Brianza",7,4237,0,0,0,4237,3978,0,0,0,3978
"108","Monza e della Brianza",8,4105,0,0,0,4105,4064,0,0,0,4064
"108","Monza e della Brianza",9,4145,0,0,0,4145,3891,0,0,0,3891
"108","Monza e della Brianza",10,3958,0,0,0,3958,3952,0,0,0,3952
"108","Monza e della Brianza",11,4235,0,0,0,4235,3896,0,0,0,3896
"108","Monza e della Brianza",12,4026,0,0,0,4026,3740,0,0,0,3740
"108","Monza e della Brianza",13,4179,0,0,0,4179,3737,0,0,0,3737
"108","Monza e della Brianza",14,3903,0,0,0,3903,3752,0,0,0,3752
"108","Monza e della Brianza",15,3870,0,0,0,3870,3702,0,0,0,3702
"108","Monza e della Brianza",16,3886,0,0,0,3886,3640,0,0,0,3640
"108","Monza e della Brianza",17,3830,0,0,0,3830,3576,1,0,0,3577
"108","Monza e della Brianza",18,3688,0,0,0,3688,3618,5,0,0,3623
"108","Monza e della Brianza",19,3909,2,0,0,3911,3550,24,0,0,3574
"108","Monza e della Brianza",20,3889,4,0,0,3893,3677,75,1,0,3753
"108","Monza e della Brianza",21,3901,13,0,0,3914,3529,111,0,0,3640
"108","Monza e della Brianza",22,3901,27,1,0,3929,3585,226,0,0,3811
"108","Monza e della Brianza",23,3849,64,0,0,3913,3610,304,0,0,3914
"108","Monza e della Brianza",24,3820,103,4,0,3927,3360,472,2,0,3834
"108","Monza e della Brianza",25,3829,167,5,0,4001,3307,619,2,0,3928
"108","Monza e della Brianza",26,3902,272,4,5,4183,3273,817,5,3,4098
"108","Monza e della Brianza",27,3909,477,3,0,4389,3159,1105,7,1,4272
"108","Monza e della Brianza",28,3819,723,10,1,4553,3023,1446,14,0,4483
"108","Monza e della Brianza",29,3826,978,7,0,4811,2811,1902,16,2,4731
"108","Monza e della Brianza",30,3676,1204,9,0,4889,2627,2259,26,6,4918
"108","Monza e della Brianza",31,3505,1641,14,1,5161,2553,2562,41,5,5161
"108","Monza e della Brianza",32,3428,1974,13,0,5415,2316,2984,57,5,5362
"108","Monza e della Brianza",33,3381,2375,32,0,5788,2213,3385,68,10,5676
"108","Monza e della Brianza",34,3253,2736,36,2,6027,2078,3671,84,15,5848
"108","Monza e della Brianza",35,3287,3181,66,7,6541,2146,3958,148,13,6265
"108","Monza e della Brianza",36,3339,3575,64,6,6984,2120,4539,150,22,6831
"108","Monza e della Brianza",37,3048,3970,100,5,7123,2046,4857,192,15,7110
"108","Monza e della Brianza",38,2891,4197,116,5,7209,1905,4877,215,35,7032
"108","Monza e della Brianza",39,2711,4399,170,13,7293,1775,5023,258,28,7084
"108","Monza e della Brianza",40,2553,4731,186,9,7479,1605,5181,290,43,7119
"108","Monza e della Brianza",41,2270,4794,194,16,7274,1515,5308,309,52,7184
"108","Monza e della Brianza",42,2110,5121,223,17,7471,1502,5452,340,59,7353
"108","Monza e della Brianza",43,2093,5158,211,13,7475,1308,5590,376,57,7331
"108","Monza e della Brianza",44,1932,5210,251,25,7418,1218,5538,375,81,7212
"108","Monza e della Brianza",45,1755,5544,288,31,7618,1174,5772,390,94,7430
"108","Monza e della Brianza",46,1608,5548,332,27,7515,1120,5718,365,103,7306
"108","Monza e della Brianza",47,1489,5675,357,36,7557,1020,5803,430,109,7362
"108","Monza e della Brianza",48,1293,5385,307,43,7028,924,5277,377,118,6696
"108","Monza e della Brianza",49,1157,5025,282,30,6494,864,5132,347,148,6491
"108","Monza e della Brianza",50,988,5020,274,43,6325,804,4865,359,146,6174
"108","Monza e della Brianza",51,910,4811,273,40,6034,716,4856,378,161,6111
"108","Monza e della Brianza",52,801,4653,265,44,5763,699,4828,333,193,6053
"108","Monza e della Brianza",53,703,4414,271,54,5442,595,4616,288,209,5708
"108","Monza e della Brianza",54,676,4571,240,50,5537,524,4567,247,250,5588
"108","Monza e della Brianza",55,606,4353,223,67,5249,515,4686,273,255,5729
"108","Monza e della Brianza",56,576,4265,201,67,5109,489,4466,265,293,5513
"108","Monza e della Brianza",57,554,4186,218,79,5037,476,4468,257,335,5536
"108","Monza e della Brianza",58,474,4193,196,98,4961,435,4235,193,370,5233
"108","Monza e della Brianza",59,501,4187,172,114,4974,416,4122,186,399,5123
"108","Monza e della Brianza",60,459,4167,153,113,4892,381,4179,164,479,5203
"108","Monza e della Brianza",61,407,4314,131,117,4969,375,4304,164,499,5342
"108","Monza e della Brianza",62,418,4245,134,123,4920,376,4180,196,626,5378
"108","Monza e della Brianza",63,403,4486,124,127,5140,388,4408,160,683,5639
"108","Monza e della Brianza",64,366,4278,128,159,4931,341,4110,156,763,5370
"108","Monza e della Brianza",65,336,4499,118,195,5148,318,4223,165,864,5570
"108","Monza e della Brianza",66,252,3278,82,168,3780,281,3201,114,695,4291
"108","Monza e della Brianza",67,231,3432,91,175,3929,277,3314,113,798,4502
"108","Monza e della Brianza",68,242,3422,52,193,3909,284,3087,113,864,4348
"108","Monza e della Brianza",69,261,3511,65,199,4036,267,3143,96,1093,4599
"108","Monza e della Brianza",70,291,3480,64,217,4052,301,3231,96,1171,4799
"108","Monza e della Brianza",71,267,3862,69,292,4490,291,3286,94,1401,5072
"108","Monza e della Brianza",72,297,3791,72,336,4496,332,3110,88,1543,5073
"108","Monza e della Brianza",73,236,3531,54,350,4171,314,2848,86,1683,4931
"108","Monza e della Brianza",74,216,3152,47,312,3727,305,2417,58,1589,4369
"108","Monza e della Brianza",75,179,2864,31,360,3434,307,2059,41,1607,4014
"108","Monza e della Brianza",76,180,2740,30,341,3291,319,1936,54,1914,4223
"108","Monza e della Brianza",77,159,2358,34,333,2884,306,1712,35,1887,3940
"108","Monza e della Brianza",78,169,2238,27,356,2790,330,1497,30,1936,3793
"108","Monza e della Brianza",79,135,2033,19,362,2549,333,1194,26,1953,3506
"108","Monza e della Brianza",80,114,1860,14,374,2362,299,1089,30,1910,3328
"108","Monza e della Brianza",81,114,1654,11,381,2160,333,957,21,2062,3373
"108","Monza e della Brianza",82,102,1366,11,348,1827,314,752,15,2062,3143
"108","Monza e della Brianza",83,72,1117,8,325,1522,289,603,17,1921,2830
"108","Monza e della Brianza",84,43,988,9,305,1345,251,453,9,1890,2603
"108","Monza e della Brianza",85,57,807,9,281,1154,217,332,13,1730,2292
"108","Monza e della Brianza",86,29,663,2,270,964,224,251,8,1621,2104
"108","Monza e della Brianza",87,31,508,1,244,784,200,197,10,1437,1844
"108","Monza e della Brianza",88,19,414,7,210,650,168,160,10,1327,1665
"108","Monza e della Brianza",89,16,270,1,178,465,137,96,10,1171,1414
"108","Monza e della Brianza",90,15,221,3,173,412,133,68,7,1034,1242
"108","Monza e della Brianza",91,7,141,1,132,281,100,45,7,868,1020
"108","Monza e della Brianza",92,3,74,0,80,157,60,14,3,444,521
"108","Monza e della Brianza",93,4,31,0,44,79,32,4,5,293,334
"108","Monza e della Brianza",94,2,24,0,30,56,35,4,1,228,268
"108","Monza e della Brianza",95,2,13,0,37,52,29,2,2,214,247
"108","Monza e della Brianza",96,4,16,0,27,47,27,5,1,232,265
"108","Monza e della Brianza",97,2,8,0,20,30,18,4,0,177,199
"108","Monza e della Brianza",98,0,8,1,19,28,15,0,1,125,141
"108","Monza e della Brianza",99,0,7,0,11,18,7,2,0,76,85
"108","Monza e della Brianza",100,0,3,0,14,17,15,2,0,107,124
"109","Fermo",0,779,0,0,0,779,730,0,0,0,730
"109","Fermo",1,782,0,0,0,782,732,0,0,0,732
"109","Fermo",2,822,0,0,0,822,715,0,0,0,715
"109","Fermo",3,778,0,0,0,778,727,0,0,0,727
"109","Fermo",4,814,0,0,0,814,769,0,0,0,769
"109","Fermo",5,758,0,0,0,758,757,0,0,0,757
"109","Fermo",6,799,0,0,0,799,729,0,0,0,729
"109","Fermo",7,758,0,0,0,758,725,0,0,0,725
"109","Fermo",8,750,0,0,0,750,720,0,0,0,720
"109","Fermo",9,778,0,0,0,778,745,0,0,0,745
"109","Fermo",10,781,0,0,0,781,747,0,0,0,747
"109","Fermo",11,802,0,0,0,802,752,0,0,0,752
"109","Fermo",12,803,0,0,0,803,762,0,0,0,762
"109","Fermo",13,799,0,0,0,799,768,0,0,0,768
"109","Fermo",14,803,0,0,0,803,717,0,0,0,717
"109","Fermo",15,815,0,0,0,815,743,0,0,0,743
"109","Fermo",16,833,0,0,0,833,790,0,0,0,790
"109","Fermo",17,788,0,0,0,788,709,1,0,0,710
"109","Fermo",18,799,0,0,0,799,766,6,0,0,772
"109","Fermo",19,846,0,0,0,846,764,18,0,0,782
"109","Fermo",20,870,1,0,0,871,777,21,0,0,798
"109","Fermo",21,797,2,0,0,799,849,31,0,0,880
"109","Fermo",22,844,12,0,0,856,764,66,0,1,831
"109","Fermo",23,864,13,0,0,877,814,78,1,0,893
"109","Fermo",24,806,26,0,0,832,797,123,0,0,920
"109","Fermo",25,918,59,0,0,977,709,164,2,0,875
"109","Fermo",26,929,60,0,0,989,745,231,2,1,979
"109","Fermo",27,848,93,1,0,942,690,243,3,2,938
"109","Fermo",28,855,137,1,0,993,678,325,3,1,1007
"109","Fermo",29,838,157,0,0,995,621,384,3,0,1008
"109","Fermo",30,805,229,2,0,1036,569,450,6,2,1027
"109","Fermo",31,739,275,0,0,1014,511,529,12,3,1055
"109","Fermo",32,741,387,3,0,1131,547,665,8,5,1225
"109","Fermo",33,713,450,0,1,1164,458,679,15,1,1153
"109","Fermo",34,632,517,5,0,1154,459,705,12,3,1179
"109","Fermo",35,710,627,6,1,1344,402,732,14,2,1150
"109","Fermo",36,578,640,10,3,1231,412,838,20,6,1276
"109","Fermo",37,581,674,20,1,1276,375,863,27,10,1275
"109","Fermo",38,513,735,16,2,1266,358,917,33,5,1313
"109","Fermo",39,453,750,13,0,1216,348,920,39,10,1317
"109","Fermo",40,446,815,18,2,1281,291,1024,40,9,1364
"109","Fermo",41,449,865,20,4,1338,267,986,41,13,1307
"109","Fermo",42,416,878,35,5,1334,251,1074,44,14,1383
"109","Fermo",43,375,900,30,3,1308,241,994,48,11,1294
"109","Fermo",44,334,1008,23,1,1366,206,1119,61,15,1401
"109","Fermo",45,337,980,38,3,1358,213,1055,56,33,1357
"109","Fermo",46,269,1026,42,6,1343,178,1061,54,24,1317
"109","Fermo",47,288,1076,33,3,1400,176,1082,66,23,1347
"109","Fermo",48,233,996,43,10,1282,145,1082,60,23,1310
"109","Fermo",49,219,1019,37,10,1285,141,1063,42,37,1283
"109","Fermo",50,228,1060,41,10,1339,134,1091,62,35,1322
"109","Fermo",51,194,1051,32,11,1288,130,1057,71,33,1291
"109","Fermo",52,172,1011,43,6,1232,121,1034,51,46,1252
"109","Fermo",53,149,1000,52,11,1212,106,997,58,53,1214
"109","Fermo",54,156,955,45,15,1171,113,995,54,53,1215
"109","Fermo",55,164,980,34,10,1188,117,1115,53,58,1343
"109","Fermo",56,117,1011,25,15,1168,95,1026,35,71,1227
"109","Fermo",57,106,938,24,16,1084,95,994,39,57,1185
"109","Fermo",58,106,886,42,27,1061,81,897,41,65,1084
"109","Fermo",59,107,911,38,14,1070,85,832,29,114,1060
"109","Fermo",60,95,891,25,26,1037,75,915,36,111,1137
"109","Fermo",61,103,919,36,24,1082,66,870,40,121,1097
"109","Fermo",62,78,896,26,30,1030,70,905,26,110,1111
"109","Fermo",63,101,938,29,18,1086,57,855,26,149,1087
"109","Fermo",64,70,907,25,25,1027,62,891,28,150,1131
"109","Fermo",65,74,881,14,30,999,47,857,26,147,1077
"109","Fermo",66,63,756,19,31,869,51,671,24,152,898
"109","Fermo",67,57,666,15,32,770,41,648,18,175,882
"109","Fermo",68,58,705,15,40,818,54,658,14,198,924
"109","Fermo",69,50,643,15,33,741,49,575,12,199,835
"109","Fermo",70,53,648,9,45,755,32,599,15,232,878
"109","Fermo",71,69,764,6,57,896,41,736,10,301,1088
"109","Fermo",72,62,847,12,71,992,46,733,12,349,1140
"109","Fermo",73,63,863,14,66,1006,47,651,6,423,1127
"109","Fermo",74,55,742,6,79,882,39,618,10,371,1038
"109","Fermo",75,49,717,4,56,826,41,545,5,376,967
"109","Fermo",76,46,700,8,84,838,38,524,5,457,1024
"109","Fermo",77,43,671,4,64,782,54,448,7,412,921
"109","Fermo",78,32,607,5,76,720,45,403,9,507,964
"109","Fermo",79,28,499,1,65,593,49,366,5,454,874
"109","Fermo",80,29,548,1,93,671,42,335,4,485,866
"109","Fermo",81,34,524,1,92,651,49,296,5,506,856
"109","Fermo",82,25,433,1,82,541,57,238,1,524,820
"109","Fermo",83,29,428,1,95,553,53,177,5,509,744
"109","Fermo",84,21,371,3,84,479,57,196,3,530,786
"109","Fermo",85,14,299,1,92,406,49,156,1,431,637
"109","Fermo",86,17,298,2,113,430,42,116,1,480,639
"109","Fermo",87,11,185,2,86,284,42,88,5,468,603
"109","Fermo",88,4,182,1,69,256,47,68,4,380,499
"109","Fermo",89,6,147,1,67,221,40,42,1,356,439
"109","Fermo",90,8,123,0,61,192,35,35,6,294,370
"109","Fermo",91,5,76,0,45,126,31,27,3,279,340
"109","Fermo",92,7,40,0,28,75,15,9,0,137,161
"109","Fermo",93,1,28,0,13,42,9,4,1,92,106
"109","Fermo",94,2,15,0,16,33,10,2,0,58,70
"109","Fermo",95,1,13,0,18,32,8,5,0,91,104
"109","Fermo",96,2,8,0,18,28,8,1,0,61,70
"109","Fermo",97,0,6,0,15,21,10,1,0,50,61
"109","Fermo",98,1,3,0,6,10,3,0,0,36,39
"109","Fermo",99,1,3,0,4,8,5,0,0,32,37
"109","Fermo",100,0,0,0,11,11,4,0,0,38,42
"110","Barletta-Andria-Trani",0,1883,0,0,0,1883,1757,0,0,0,1757
"110","Barletta-Andria-Trani",1,1942,0,0,0,1942,1877,0,0,0,1877
"110","Barletta-Andria-Trani",2,1983,0,0,0,1983,1917,0,0,0,1917
"110","Barletta-Andria-Trani",3,2031,0,0,0,2031,1893,0,0,0,1893
"110","Barletta-Andria-Trani",4,2124,0,0,0,2124,1982,0,0,0,1982
"110","Barletta-Andria-Trani",5,2138,0,0,0,2138,2009,0,0,0,2009
"110","Barletta-Andria-Trani",6,2180,0,0,0,2180,1975,0,0,0,1975
"110","Barletta-Andria-Trani",7,2241,0,0,0,2241,2079,0,0,0,2079
"110","Barletta-Andria-Trani",8,2259,0,0,0,2259,2087,0,0,0,2087
"110","Barletta-Andria-Trani",9,2267,0,0,0,2267,2246,0,0,0,2246
"110","Barletta-Andria-Trani",10,2245,0,0,0,2245,2210,0,0,0,2210
"110","Barletta-Andria-Trani",11,2326,0,0,0,2326,2379,0,0,0,2379
"110","Barletta-Andria-Trani",12,2427,0,0,0,2427,2245,0,0,0,2245
"110","Barletta-Andria-Trani",13,2293,0,0,0,2293,2164,0,0,0,2164
"110","Barletta-Andria-Trani",14,2397,0,0,0,2397,2273,0,0,0,2273
"110","Barletta-Andria-Trani",15,2386,0,0,0,2386,2149,0,0,0,2149
"110","Barletta-Andria-Trani",16,2344,0,0,0,2344,2227,0,0,0,2227
"110","Barletta-Andria-Trani",17,2493,0,0,0,2493,2332,2,0,0,2334
"110","Barletta-Andria-Trani",18,2394,0,0,0,2394,2251,7,0,0,2258
"110","Barletta-Andria-Trani",19,2580,1,0,0,2581,2356,29,1,0,2386
"110","Barletta-Andria-Trani",20,2639,8,0,0,2647,2344,53,0,0,2397
"110","Barletta-Andria-Trani",21,2563,19,0,0,2582,2299,82,1,0,2382
"110","Barletta-Andria-Trani",22,2519,26,1,0,2546,2263,141,0,0,2404
"110","Barletta-Andria-Trani",23,2506,51,0,0,2557,2166,240,0,0,2406
"110","Barletta-Andria-Trani",24,2446,78,0,0,2524,2057,330,0,1,2388
"110","Barletta-Andria-Trani",25,2446,128,0,0,2574,1852,491,1,0,2344
"110","Barletta-Andria-Trani",26,2145,213,0,0,2358,1710,597,2,1,2310
"110","Barletta-Andria-Trani",27,2170,316,0,0,2486,1568,884,1,0,2453
"110","Barletta-Andria-Trani",28,2029,459,0,0,2488,1385,1026,2,2,2415
"110","Barletta-Andria-Trani",29,1825,655,2,1,2483,1266,1294,4,1,2565
"110","Barletta-Andria-Trani",30,1692,824,2,0,2518,1048,1442,11,3,2504
"110","Barletta-Andria-Trani",31,1491,1047,2,1,2541,908,1666,7,6,2587
"110","Barletta-Andria-Trani",32,1338,1320,2,1,2661,821,1873,19,8,2721
"110","Barletta-Andria-Trani",33,1337,1509,7,1,2854,707,2023,9,11,2750
"110","Barletta-Andria-Trani",34,1162,1780,8,5,2955,642,2226,26,7,2901
"110","Barletta-Andria-Trani",35,996,1926,7,2,2931,565,2361,23,12,2961
"110","Barletta-Andria-Trani",36,917,2082,14,1,3014,510,2417,18,20,2965
"110","Barletta-Andria-Trani",37,904,2189,18,3,3114,522,2645,44,19,3230
"110","Barletta-Andria-Trani",38,772,2165,12,7,2956,498,2539,35,13,3085
"110","Barletta-Andria-Trani",39,676,2345,21,4,3046,417,2574,52,23,3066
"110","Barletta-Andria-Trani",40,692,2496,23,4,3215,422,2676,44,30,3172
"110","Barletta-Andria-Trani",41,597,2511,36,13,3157,360,2680,53,45,3138
"110","Barletta-Andria-Trani",42,527,2537,39,4,3107,360,2886,60,40,3346
"110","Barletta-Andria-Trani",43,475,2707,39,9,3230,348,2662,50,45,3105
"110","Barletta-Andria-Trani",44,470,2723,35,5,3233,325,2651,53,57,3086
"110","Barletta-Andria-Trani",45,397,2670,38,10,3115,300,2875,48,64,3287
"110","Barletta-Andria-Trani",46,359,2618,33,6,3016,299,2668,77,50,3094
"110","Barletta-Andria-Trani",47,327,2759,46,13,3145,294,2836,57,70,3257
"110","Barletta-Andria-Trani",48,283,2648,42,13,2986,247,2614,51,73,2985
"110","Barletta-Andria-Trani",49,252,2594,35,15,2896,269,2543,54,78,2944
"110","Barletta-Andria-Trani",50,244,2486,33,21,2784,246,2433,58,86,2823
"110","Barletta-Andria-Trani",51,210,2357,35,25,2627,248,2298,50,101,2697
"110","Barletta-Andria-Trani",52,202,2351,36,22,2611,233,2313,47,102,2695
"110","Barletta-Andria-Trani",53,174,2140,39,22,2375,210,2169,46,113,2538
"110","Barletta-Andria-Trani",54,176,2258,48,27,2509,205,2177,38,128,2548
"110","Barletta-Andria-Trani",55,162,2077,23,27,2289,202,1998,36,128,2364
"110","Barletta-Andria-Trani",56,145,2064,30,36,2275,169,2014,44,145,2372
"110","Barletta-Andria-Trani",57,146,1982,31,29,2188,173,2018,46,162,2399
"110","Barletta-Andria-Trani",58,121,1915,30,37,2103,172,1823,42,164,2201
"110","Barletta-Andria-Trani",59,104,1885,19,39,2047,159,1716,43,204,2122
"110","Barletta-Andria-Trani",60,123,1894,22,42,2081,167,1876,28,202,2273
"110","Barletta-Andria-Trani",61,115,1960,22,46,2143,159,1770,35,238,2202
"110","Barletta-Andria-Trani",62,95,1980,24,56,2155,163,1779,30,253,2225
"110","Barletta-Andria-Trani",63,122,2108,20,63,2313,172,1900,31,306,2409
"110","Barletta-Andria-Trani",64,96,1938,23,81,2138,154,1788,30,300,2272
"110","Barletta-Andria-Trani",65,110,1997,28,61,2196,158,1779,32,346,2315
"110","Barletta-Andria-Trani",66,82,1622,14,76,1794,150,1350,19,343,1862
"110","Barletta-Andria-Trani",67,79,1487,11,81,1658,120,1268,21,329,1738
"110","Barletta-Andria-Trani",68,76,1495,8,111,1690,124,1209,13,349,1695
"110","Barletta-Andria-Trani",69,87,1441,10,102,1640,141,1233,13,393,1780
"110","Barletta-Andria-Trani",70,58,1367,14,109,1548,143,1103,16,431,1693
"110","Barletta-Andria-Trani",71,73,1501,10,122,1706,118,1167,22,527,1834
"110","Barletta-Andria-Trani",72,58,1375,12,118,1563,117,1091,17,532,1757
"110","Barletta-Andria-Trani",73,56,1215,13,135,1419,127,942,17,538,1624
"110","Barletta-Andria-Trani",74,66,1240,14,119,1439,122,954,19,579,1674
"110","Barletta-Andria-Trani",75,44,1068,10,133,1255,106,754,14,613,1487
"110","Barletta-Andria-Trani",76,34,1064,11,154,1263,106,784,11,626,1527
"110","Barletta-Andria-Trani",77,38,969,6,138,1151,124,663,5,674,1466
"110","Barletta-Andria-Trani",78,32,823,7,158,1020,93,603,11,665,1372
"110","Barletta-Andria-Trani",79,34,808,5,151,998,81,517,13,701,1312
"110","Barletta-Andria-Trani",80,20,776,4,177,977,104,452,7,788,1351
"110","Barletta-Andria-Trani",81,23,702,3,159,887,83,390,6,757,1236
"110","Barletta-Andria-Trani",82,35,539,5,177,756,92,306,10,717,1125
"110","Barletta-Andria-Trani",83,19,492,1,162,674,90,212,3,662,967
"110","Barletta-Andria-Trani",84,22,444,3,164,633,94,202,5,655,956
"110","Barletta-Andria-Trani",85,13,369,6,177,565,59,163,5,616,843
"110","Barletta-Andria-Trani",86,16,252,0,148,416,65,107,4,529,705
"110","Barletta-Andria-Trani",87,12,208,1,142,363,72,77,3,498,650
"110","Barletta-Andria-Trani",88,13,186,1,124,324,54,54,1,459,568
"110","Barletta-Andria-Trani",89,6,133,0,108,247,39,55,3,407,504
"110","Barletta-Andria-Trani",90,7,101,1,101,210,40,21,1,359,421
"110","Barletta-Andria-Trani",91,7,85,1,106,199,28,25,1,313,367
"110","Barletta-Andria-Trani",92,2,39,1,42,84,18,6,0,158,182
"110","Barletta-Andria-Trani",93,2,15,0,33,50,18,2,0,107,127
"110","Barletta-Andria-Trani",94,2,21,0,22,45,7,5,1,84,97
"110","Barletta-Andria-Trani",95,0,10,0,21,31,7,2,0,81,90
"110","Barletta-Andria-Trani",96,0,5,0,14,19,2,3,0,51,56
"110","Barletta-Andria-Trani",97,2,8,1,10,21,9,3,2,48,62
"110","Barletta-Andria-Trani",98,1,2,0,9,12,8,0,0,33,41
"110","Barletta-Andria-Trani",99,2,0,0,7,9,2,1,0,27,30
"110","Barletta-Andria-Trani",100,1,1,0,7,9,6,0,0,37,43
